report_date,pcr_neg,pcr_pos,pcr_int,pcr_total,pcr_avg
2020-03-16,409,30,0,439,NA
2020-03-17,635,50,0,685,NA
2020-03-18,737,56,2,795,NA
2020-03-19,1056,71,1,1128,NA
2020-03-20,1076,104,2,1182,NA
2020-03-21,741,82,2,825,NA
2020-03-22,626,79,0,705,822.7142857142857
2020-03-23,1628,176,4,1808,1018.2857142857143
2020-03-24,1850,214,0,2064,1215.2857142857142
2020-03-25,2205,224,6,2435,1449.5714285714287
2020-03-26,2166,258,1,2425,1634.857142857143
2020-03-27,1841,296,0,2137,1771.2857142857142
2020-03-28,1090,193,2,1285,1837
2020-03-29,747,139,0,886,1862.857142857143
2020-03-30,2407,361,0,2768,2000
2020-03-31,2167,301,1,2469,2057.8571428571427
2020-04-01,2021,274,2,2297,2038.142857142857
2020-04-02,1886,292,3,2181,2003.2857142857142
2020-04-03,1731,250,2,1983,1981.2857142857142
2020-04-04,950,145,2,1097,1954.4285714285713
2020-04-05,784,113,3,900,1956.4285714285713
2020-04-06,2417,319,7,2743,1952.857142857143
2020-04-07,2081,242,2,2325,1932.2857142857142
2020-04-08,2060,252,1,2313,1934.5714285714287
2020-04-09,1766,214,4,1984,1906.4285714285713
2020-04-10,1986,241,5,2232,1942
2020-04-11,851,105,1,957,1922
2020-04-12,694,98,3,795,1907
2020-04-13,1977,282,4,2263,1838.4285714285713
2020-04-14,1959,235,6,2200,1820.5714285714287
2020-04-15,1831,241,4,2076,1786.7142857142858
2020-04-16,1840,234,4,2078,1800.142857142857
2020-04-17,2171,202,4,2377,1820.857142857143
2020-04-18,1080,173,0,1253,1863.142857142857
2020-04-19,830,150,2,982,1889.857142857143
2020-04-20,2443,315,10,2768,1962
2020-04-21,2297,273,9,2579,2016.142857142857
2020-04-22,2704,279,6,2989,2146.5714285714284
2020-04-23,2639,282,9,2930,2268.285714285714
2020-04-24,2470,263,17,2750,2321.5714285714284
2020-04-25,1172,139,1,1312,2330
2020-04-26,1042,90,1,1133,2351.5714285714284
2020-04-27,3780,349,7,4136,2547
2020-04-28,4564,428,14,5006,2893.714285714286
2020-04-29,4555,379,9,4943,3172.8571428571427
2020-04-30,3839,333,11,4183,3351.8571428571427
2020-05-01,4216,335,13,4564,3611
2020-05-02,1577,93,2,1672,3662.4285714285716
2020-05-03,1089,89,2,1180,3669.1428571428573
2020-05-04,3856,302,14,4172,3674.285714285714
2020-05-05,4618,327,17,4962,3668
2020-05-06,4075,259,8,4342,3582.1428571428573
2020-05-07,3768,180,10,3958,3550
2020-05-08,4390,177,6,4573,3551.285714285714
2020-05-09,2099,133,4,2236,3631.8571428571427
2020-05-10,1253,76,0,1329,3653.1428571428573
2020-05-11,5055,260,11,5326,3818
2020-05-12,5257,233,7,5497,3894.4285714285716
2020-05-13,5340,339,9,5688,4086.714285714286
2020-05-14,4860,266,3,5129,4254
2020-05-15,5682,253,13,5948,4450.428571428572
2020-05-16,3882,99,2,3983,4700
2020-05-17,2765,124,3,2892,4923.285714285715
2020-05-18,6443,283,6,6732,5124.142857142857
2020-05-19,5782,298,6,6086,5208.285714285715
2020-05-20,5745,306,3,6054,5260.571428571428
2020-05-21,5581,320,10,5911,5372.285714285715
2020-05-22,6892,251,9,7152,5544.285714285715
2020-05-23,2987,109,2,3098,5417.857142857143
2020-05-24,2457,82,3,2542,5367.857142857143
2020-05-25,2348,93,2,2443,4755.142857142857
2020-05-26,12653,362,13,13028,5746.857142857143
2020-05-27,11510,356,10,11876,6578.571428571428
2020-05-28,10206,270,7,10483,7231.714285714285
2020-05-29,9476,270,7,9753,7603.285714285715
2020-05-30,4329,323,4,4656,7825.857142857143
2020-05-31,2767,212,3,2982,7888.714285714285
2020-06-01,10083,349,81,10513,9041.57142857143
2020-06-02,8397,282,13,8692,8422.142857142857
2020-06-03,8770,278,10,9058,8019.571428571428
2020-06-04,7637,308,18,7963,7659.571428571428
2020-06-05,8692,322,9,9023,7555.285714285715
2020-06-06,3315,124,3,3442,7381.857142857143
2020-06-07,2322,81,0,2403,7299.142857142857
2020-06-08,9489,368,8,9865,7206.571428571428
2020-06-09,10173,387,2,10562,7473.714285714285
2020-06-10,9894,378,10,10282,7648.571428571428
2020-06-11,7935,347,7,8289,7695.142857142857
2020-06-12,8451,389,10,8850,7670.428571428572
2020-06-13,3820,171,6,3997,7749.714285714285
2020-06-14,2601,124,1,2726,7795.857142857143
2020-06-15,13847,520,43,14410,8445.142857142857
2020-06-16,11651,577,112,12340,8699.142857142857
2020-06-17,9768,512,19,10299,8701.57142857143
2020-06-18,9492,664,41,10197,8974.142857142857
2020-06-19,10491,492,18,11001,9281.42857142857
2020-06-20,4480,258,11,4749,9388.857142857143
2020-06-21,2877,233,0,3110,9443.714285714286
2020-06-22,15401,719,92,16212,9701.142857142857
2020-06-23,11689,668,26,12383,9707.285714285714
2020-06-24,11009,745,29,11783,9919.285714285714
2020-06-25,9443,652,16,10111,9907
2020-06-26,11769,667,10,12446,10113.42857142857
2020-06-27,5562,412,3,5977,10288.857142857143
2020-06-28,4619,279,2,4900,10544.57142857143
2020-06-29,17532,984,33,18549,10878.42857142857
2020-06-30,14239,989,16,15244,11287.142857142857
2020-07-01,13501,1062,25,14588,11687.857142857143
2020-07-02,12583,1077,14,13674,12196.857142857143
2020-07-03,8005,715,14,8734,11666.57142857143
2020-07-04,3627,359,6,3992,11383
2020-07-05,4039,378,0,4417,11314
2020-07-06,16025,1297,12,17334,11140.42857142857
2020-07-07,15811,1344,18,17173,11416
2020-07-08,15362,1464,21,16847,11738.714285714286
2020-07-09,15253,1324,39,16616,12159
2020-07-10,14907,1271,36,16214,13227.57142857143
2020-07-11,8708,716,28,9452,14007.57142857143
2020-07-12,5791,494,7,6292,14275.42857142857
2020-07-13,20705,1535,52,22292,14983.714285714286
2020-07-14,18064,1455,35,19554,15323.857142857143
2020-07-15,16328,1274,22,17624,15434.857142857143
2020-07-16,13623,1221,14,14858,15183.714285714286
2020-07-17,14636,1177,14,15827,15128.42857142857
2020-07-18,7541,757,15,8313,14965.714285714286
2020-07-19,4999,554,12,5565,14861.857142857143
2020-07-20,20187,1700,32,21919,14808.57142857143
2020-07-21,16707,1450,34,18191,14613.857142857143
2020-07-22,13631,1411,22,15064,14248.142857142857
2020-07-23,14239,1401,35,15675,14364.857142857143
2020-07-24,14510,1318,25,15853,14368.57142857143
2020-07-25,7642,650,10,8302,14367
2020-07-26,5397,493,15,5905,14415.57142857143
2020-07-27,18567,1547,40,20154,14163.42857142857
2020-07-28,17450,1328,31,18809,14251.714285714286
2020-07-29,13610,1413,27,15050,14249.714285714286
2020-07-30,12443,1237,18,13698,13967.285714285714
2020-07-31,12954,1121,10,14085,13714.714285714286
2020-08-01,7224,610,20,7854,13650.714285714286
2020-08-02,5358,614,22,5994,13663.42857142857
2020-08-03,19875,1645,41,21561,13864.42857142857
2020-08-04,15955,1408,26,17389,13661.57142857143
2020-08-05,13040,1362,19,14421,13571.714285714286
2020-08-06,12348,1129,13,13490,13542
2020-08-07,13274,1112,20,14406,13587.857142857143
2020-08-08,6699,700,10,7409,13524.285714285714
2020-08-09,5137,490,6,5633,13472.714285714286
2020-08-10,17055,1447,19,18521,13038.42857142857
2020-08-11,14270,1255,29,15554,12776.285714285714
2020-08-12,12160,1415,36,13611,12660.57142857143
2020-08-13,12874,1142,15,14031,12737.857142857143
2020-08-14,13515,1141,13,14669,12775.42857142857
2020-08-15,5955,644,10,6609,12661.142857142857
2020-08-16,4903,534,14,5451,12635.142857142857
2020-08-17,12691,1476,18,14185,12015.714285714286
2020-08-18,13147,1209,24,14380,11848
2020-08-19,10567,1172,18,11757,11583.142857142857
2020-08-20,9094,984,17,10095,11020.857142857143
2020-08-21,7716,682,10,8408,10126.42857142857
2020-08-22,2019,100,0,2119,9485
