report_date,pcr_neg,pcr_pos,pcr_int,pcr_total,pcr_avg
2020-03-16,409,30,0,439,NA
2020-03-17,635,50,0,685,NA
2020-03-18,738,57,2,797,NA
2020-03-19,1057,71,1,1129,NA
2020-03-20,1076,103,2,1181,NA
2020-03-21,741,82,2,825,NA
2020-03-22,626,79,0,705,823
2020-03-23,1630,176,4,1810,1018.8571428571429
2020-03-24,1850,214,0,2064,1215.857142857143
2020-03-25,2221,224,6,2451,1452.142857142857
2020-03-26,2172,258,1,2431,1638.142857142857
2020-03-27,1883,296,0,2179,1780.7142857142858
2020-03-28,1092,195,2,1289,1847
2020-03-29,751,139,0,890,1873.4285714285713
2020-03-30,2429,361,0,2790,2013.4285714285713
2020-03-31,2203,301,1,2505,2076.4285714285716
2020-04-01,2045,273,2,2320,2057.714285714286
2020-04-02,1889,292,3,2184,2022.4285714285713
2020-04-03,1733,250,2,1985,1994.7142857142858
2020-04-04,952,146,2,1100,1967.7142857142858
2020-04-05,784,113,3,900,1969.142857142857
2020-04-06,2417,320,7,2744,1962.5714285714287
2020-04-07,2081,242,2,2325,1936.857142857143
2020-04-08,2060,252,1,2313,1935.857142857143
2020-04-09,1766,218,4,1988,1907.857142857143
2020-04-10,1986,241,5,2232,1943.142857142857
2020-04-11,851,107,1,959,1923
2020-04-12,694,102,3,799,1908.5714285714287
2020-04-13,1978,287,4,2269,1840.7142857142858
2020-04-14,1966,235,6,2207,1823.857142857143
2020-04-15,1844,242,4,2090,1792
2020-04-16,1846,235,4,2085,1805.857142857143
2020-04-17,2177,203,4,2384,1827.5714285714287
2020-04-18,1084,173,0,1257,1870.142857142857
2020-04-19,832,151,2,985,1896.7142857142858
2020-04-20,2459,317,10,2786,1970.5714285714287
2020-04-21,2301,275,9,2585,2024.5714285714287
2020-04-22,2709,279,6,2994,2153.714285714286
2020-04-23,2658,281,9,2948,2277
2020-04-24,2483,263,17,2763,2331.1428571428573
2020-04-25,1180,139,1,1320,2340.1428571428573
2020-04-26,1053,90,1,1144,2362.8571428571427
2020-04-27,3791,350,7,4148,2557.4285714285716
2020-04-28,4575,431,14,5020,2905.285714285714
2020-04-29,4622,380,9,5011,3193.4285714285716
2020-04-30,3870,336,11,4217,3374.714285714286
2020-05-01,4246,339,13,4598,3636.8571428571427
2020-05-02,1588,91,2,1681,3688.4285714285716
2020-05-03,1103,90,2,1195,3695.714285714286
2020-05-04,3872,304,14,4190,3701.714285714286
2020-05-05,4635,325,17,4977,3695.5714285714284
2020-05-06,4091,259,8,4358,3602.285714285714
2020-05-07,3783,182,10,3975,3567.714285714286
2020-05-08,4408,178,6,4592,3566.8571428571427
2020-05-09,2146,133,4,2283,3652.8571428571427
2020-05-10,1267,76,0,1343,3674
2020-05-11,5081,262,11,5354,3840.285714285714
2020-05-12,5278,233,7,5518,3917.5714285714284
2020-05-13,5374,343,9,5726,4113
2020-05-14,4880,265,4,5149,4280.714285714285
2020-05-15,5709,255,14,5978,4478.714285714285
2020-05-16,3890,100,2,3992,4722.857142857143
2020-05-17,2773,125,3,2901,4945.428571428572
2020-05-18,6482,282,6,6770,5147.714285714285
2020-05-19,5826,299,6,6131,5235.285714285715
2020-05-20,5840,307,4,6151,5296
2020-05-21,5622,320,10,5952,5410.714285714285
2020-05-22,6930,252,9,7191,5584
2020-05-23,2995,109,2,3106,5457.428571428572
2020-05-24,2462,82,3,2547,5406.857142857143
2020-05-25,2364,94,2,2460,4791.142857142857
2020-05-26,12718,363,13,13094,5785.857142857143
2020-05-27,11591,357,9,11957,6615.285714285715
2020-05-28,10310,271,7,10588,7277.571428571428
2020-05-29,9520,272,7,9799,7650.142857142857
2020-05-30,4342,322,4,4668,7873.285714285715
2020-05-31,2780,215,3,2998,7937.714285714285
2020-06-01,10169,355,81,10605,9101.285714285714
2020-06-02,8529,285,13,8827,8491.714285714286
2020-06-03,8819,282,10,9111,8085.142857142857
2020-06-04,7713,310,18,8041,7721.285714285715
2020-06-05,8725,321,9,9055,7615
2020-06-06,3374,125,3,3502,7448.428571428572
2020-06-07,2340,81,0,2421,7366
2020-06-08,9587,369,9,9965,7274.571428571428
2020-06-09,10192,386,2,10580,7525
2020-06-10,9996,378,10,10384,7706.857142857143
2020-06-11,10497,618,8,11123,8147.142857142857
2020-06-12,8496,390,10,8896,8124.428571428572
2020-06-13,3835,171,6,4012,8197.285714285714
2020-06-14,2607,124,1,2732,8241.714285714286
2020-06-15,13929,521,44,14494,8888.714285714286
2020-06-16,11693,576,111,12380,9145.857142857143
2020-06-17,9849,514,19,10382,9145.57142857143
2020-06-18,9554,664,41,10259,9022.142857142857
2020-06-19,10551,493,17,11061,9331.42857142857
2020-06-20,4490,258,11,4759,9438.142857142857
2020-06-21,2900,234,0,3134,9495.57142857143
2020-06-22,15732,725,92,16549,9789.142857142857
2020-06-23,11987,673,26,12686,9832.857142857143
2020-06-24,11310,742,29,12081,10075.57142857143
2020-06-25,9764,661,16,10441,10101.57142857143
2020-06-26,12030,670,9,12709,10337
2020-06-27,5667,425,3,6095,10527.857142857143
2020-06-28,4656,292,2,4950,10787.285714285714
2020-06-29,17977,1003,33,19013,11139.285714285714
2020-06-30,14625,1011,16,15652,11563
2020-07-01,13925,1081,25,15031,11984.42857142857
2020-07-02,13108,1110,14,14232,12526
2020-07-03,8376,735,15,9126,12014.142857142857
2020-07-04,3712,357,6,4075,11725.57142857143
2020-07-05,4077,379,0,4456,11655
2020-07-06,16820,1315,12,18147,11531.285714285714
2020-07-07,16489,1386,19,17894,11851.57142857143
2020-07-08,16070,1490,22,17582,12216
2020-07-09,15579,1353,40,16972,12607.42857142857
2020-07-10,15085,1301,36,16422,13649.714285714286
2020-07-11,8901,722,29,9652,14446.42857142857
2020-07-12,5838,497,7,6342,14715.857142857143
2020-07-13,20927,1544,57,22528,15341.714285714286
2020-07-14,18364,1490,34,19888,15626.57142857143
2020-07-15,16689,1323,22,18034,15691.142857142857
2020-07-16,13908,1234,14,15156,15431.714285714286
2020-07-17,15046,1191,15,16252,15407.42857142857
2020-07-18,7570,765,15,8350,15221.42857142857
2020-07-19,5035,563,12,5610,15116.857142857143
2020-07-20,20395,1704,31,22130,15060
2020-07-21,16851,1463,35,18349,14840.142857142857
2020-07-22,13840,1416,22,15278,14446.42857142857
2020-07-23,14421,1410,37,15868,14548.142857142857
2020-07-24,14789,1319,29,16137,14531.714285714286
2020-07-25,7679,653,10,8342,14530.57142857143
2020-07-26,5435,495,15,5945,14578.42857142857
2020-07-27,18939,1553,40,20532,14350.142857142857
2020-07-28,17872,1360,30,19262,14480.57142857143
2020-07-29,14074,1447,28,15549,14519.285714285714
2020-07-30,12909,1252,19,14180,14278.142857142857
2020-07-31,13448,1125,10,14583,14056.142857142857
2020-08-01,7319,613,20,7952,14000.42857142857
2020-08-02,5428,622,23,6073,14018.714285714286
2020-08-03,20379,1677,45,22101,14242.857142857143
2020-08-04,16837,1435,27,18299,14105.285714285714
2020-08-05,14565,1376,17,15958,14163.714285714286
2020-08-06,13739,1147,15,14901,14266.714285714286
2020-08-07,14176,1093,22,15291,14367.857142857143
2020-08-08,6768,686,8,7462,14297.857142857143
2020-08-09,5222,469,7,5698,14244.285714285714
2020-08-10,17571,1452,21,19044,13807.57142857143
2020-08-11,15817,1296,26,17139,13641.857142857143
2020-08-12,14109,1377,30,15516,13578.714285714286
2020-08-13,13121,1122,15,14258,13486.857142857143
2020-08-14,13813,1123,13,14949,13438
2020-08-15,6181,635,12,6828,13347.42857142857
2020-08-16,4975,529,14,5518,13321.714285714286
2020-08-17,14829,1477,18,16324,12933.142857142857
2020-08-18,15167,1212,20,16399,12827.42857142857
2020-08-19,13306,1227,24,14557,12690.42857142857
2020-08-20,12214,1208,20,13442,12573.857142857143
2020-08-21,12376,1091,15,13482,12364.285714285714
2020-08-22,5615,551,9,6175,12271
2020-08-23,4026,500,14,4540,12131.285714285714
2020-08-24,14751,1498,27,16276,12124.42857142857
2020-08-25,13976,1343,24,15343,11973.57142857143
2020-08-26,12664,1417,26,14107,11909.285714285714
2020-08-27,12887,1257,15,14159,12011.714285714286
2020-08-28,11827,1259,21,13107,11958.142857142857
2020-08-29,6067,680,9,6756,12041.142857142857
2020-08-30,4265,542,8,4815,12080.42857142857
2020-08-31,13882,1638,34,15554,11977.285714285714
2020-09-01,13404,1426,27,14857,11907.857142857143
2020-09-02,13731,1462,40,15233,12068.714285714286
2020-09-03,14125,1327,65,15517,12262.714285714286
2020-09-04,14061,1305,15,15381,12587.57142857143
2020-09-05,6527,721,9,7257,12659.142857142857
2020-09-06,4938,588,32,5558,12765.285714285714
2020-09-07,5849,669,3,6521,11474.857142857143
2020-09-08,19377,1951,36,21364,12404.42857142857
2020-09-09,14497,1825,30,16352,12564.285714285714
2020-09-10,14174,1511,17,15702,12590.714285714286
2020-09-11,14849,1405,22,16276,12718.57142857143
2020-09-12,6816,730,7,7553,12760.857142857143
2020-09-13,5263,565,5,5833,12800.142857142857
2020-09-14,19893,1778,35,21706,14969.42857142857
2020-09-15,17220,1611,28,18859,14611.57142857143
2020-09-16,13845,1483,11,15339,14466.857142857143
2020-09-17,12795,1414,23,14232,14256.857142857143
2020-09-18,11938,1172,14,13124,13806.57142857143
2020-09-19,5458,479,9,5946,13577
