report_date,pcr_neg,pcr_pos,pcr_int,pcr_total,pcr_avg
2020-03-16,409,30,0,439,NA
2020-03-17,635,50,0,685,NA
2020-03-18,738,57,2,797,NA
2020-03-19,1057,71,1,1129,NA
2020-03-20,1076,104,2,1182,NA
2020-03-21,741,82,2,825,NA
2020-03-22,626,80,0,706,823.2857142857143
2020-03-23,1630,176,4,1810,1019.1428571428571
2020-03-24,1850,214,0,2064,1216.142857142857
2020-03-25,2221,224,6,2451,1452.4285714285713
2020-03-26,2174,258,1,2433,1638.7142857142858
2020-03-27,1883,296,0,2179,1781.142857142857
2020-03-28,1092,193,2,1287,1847.142857142857
2020-03-29,752,139,0,891,1873.5714285714287
2020-03-30,2426,361,0,2787,2013.142857142857
2020-03-31,2199,301,1,2501,2075.5714285714284
2020-04-01,2047,275,2,2324,2057.4285714285716
2020-04-02,1888,292,3,2183,2021.7142857142858
2020-04-03,1733,251,2,1986,1994.142857142857
2020-04-04,952,146,2,1100,1967.4285714285713
2020-04-05,784,113,3,900,1968.7142857142858
2020-04-06,2417,319,7,2743,1962.4285714285713
2020-04-07,2082,242,2,2326,1937.4285714285713
2020-04-08,2060,252,1,2313,1935.857142857143
2020-04-09,1766,216,4,1986,1907.7142857142858
2020-04-10,1986,241,5,2232,1942.857142857143
2020-04-11,851,105,1,957,1922.4285714285713
2020-04-12,694,101,3,798,1907.857142857143
2020-04-13,1982,287,4,2273,1840.7142857142858
2020-04-14,1964,235,6,2205,1823.4285714285713
2020-04-15,1842,243,4,2089,1791.4285714285713
2020-04-16,1851,236,4,2091,1806.4285714285713
2020-04-17,2181,202,4,2387,1828.5714285714287
2020-04-18,1086,174,0,1260,1871.857142857143
2020-04-19,832,150,2,984,1898.4285714285713
2020-04-20,2458,316,10,2784,1971.4285714285713
2020-04-21,2305,275,9,2589,2026.2857142857142
2020-04-22,2710,279,6,2995,2155.714285714286
2020-04-23,2655,281,9,2945,2277.714285714286
2020-04-24,2480,263,17,2760,2331
2020-04-25,1180,139,1,1320,2339.5714285714284
2020-04-26,1052,90,1,1143,2362.285714285714
2020-04-27,3790,349,7,4146,2556.8571428571427
2020-04-28,4574,431,14,5019,2904
2020-04-29,4619,380,9,5008,3191.5714285714284
2020-04-30,3880,335,11,4226,3374.5714285714284
2020-05-01,4259,340,13,4612,3639.1428571428573
2020-05-02,1590,92,2,1684,3691.1428571428573
2020-05-03,1105,90,2,1197,3698.8571428571427
2020-05-04,3874,304,14,4192,3705.4285714285716
2020-05-05,4633,326,17,4976,3699.285714285714
2020-05-06,4090,261,8,4359,3606.5714285714284
2020-05-07,3783,182,10,3975,3570.714285714286
2020-05-08,4407,178,6,4591,3567.714285714286
2020-05-09,2109,133,4,2246,3648
2020-05-10,1266,76,0,1342,3668.714285714286
2020-05-11,5076,261,11,5348,3833.8571428571427
2020-05-12,5280,234,7,5521,3911.714285714286
2020-05-13,5360,340,9,5709,4104.571428571428
2020-05-14,4875,266,3,5144,4271.571428571428
2020-05-15,5704,254,13,5971,4468.714285714285
2020-05-16,3890,100,2,3992,4718.142857142857
2020-05-17,2772,125,3,2900,4940.714285714285
2020-05-18,6477,283,6,6766,5143.285714285715
2020-05-19,5822,298,6,6126,5229.714285714285
2020-05-20,5833,308,3,6144,5291.857142857143
2020-05-21,5619,320,10,5949,5406.857142857143
2020-05-22,6924,251,9,7184,5580.142857142857
2020-05-23,2995,109,2,3106,5453.571428571428
2020-05-24,2463,82,3,2548,5403.285714285715
2020-05-25,2362,94,2,2458,4787.857142857143
2020-05-26,12715,362,13,13090,5782.714285714285
2020-05-27,11588,359,10,11957,6613.142857142857
2020-05-28,10307,271,7,10585,7275.428571428572
2020-05-29,9521,271,7,9799,7649
2020-05-30,4342,327,4,4673,7872.857142857143
2020-05-31,2779,215,3,2997,7937
2020-06-01,10167,355,81,10603,9100.57142857143
2020-06-02,8528,284,13,8825,8491.285714285714
2020-06-03,8818,282,10,9110,8084.571428571428
2020-06-04,7711,309,18,8038,7720.714285714285
2020-06-05,8724,322,9,9055,7614.428571428572
2020-06-06,3373,125,3,3501,7447
2020-06-07,2339,81,0,2420,7364.571428571428
2020-06-08,9581,369,8,9958,7272.428571428572
2020-06-09,10190,386,2,10578,7522.857142857143
2020-06-10,9996,378,10,10384,7704.857142857143
2020-06-11,7977,484,8,8469,7766.428571428572
2020-06-12,8498,389,10,8897,7743.857142857143
2020-06-13,3831,171,6,4008,7816.285714285715
2020-06-14,2607,124,1,2732,7860.857142857143
2020-06-15,13926,522,43,14491,8508.42857142857
2020-06-16,11690,577,112,12379,8765.714285714286
2020-06-17,9842,513,19,10374,8764.285714285714
2020-06-18,9555,666,41,10262,9020.42857142857
2020-06-19,10549,492,18,11059,9329.285714285714
2020-06-20,4489,258,11,4758,9436.42857142857
2020-06-21,2900,235,0,3135,9494
2020-06-22,15727,729,92,16548,9787.857142857143
2020-06-23,12005,677,27,12709,9835
2020-06-24,11313,757,29,12099,10081.42857142857
2020-06-25,9762,661,16,10439,10106.714285714286
2020-06-26,12042,675,10,12727,10345
2020-06-27,5669,432,3,6104,10537.285714285714
2020-06-28,4657,291,2,4950,10796.57142857143
2020-06-29,17966,1011,33,19010,11148.285714285714
2020-06-30,14607,1011,16,15634,11566.142857142857
2020-07-01,13916,1078,24,15018,11983.142857142857
2020-07-02,13098,1109,14,14221,12523.42857142857
2020-07-03,8347,736,14,9097,12004.857142857143
2020-07-04,3712,358,6,4076,11715.142857142857
2020-07-05,4078,379,0,4457,11644.714285714286
2020-07-06,16808,1309,13,18130,11519
2020-07-07,16475,1386,18,17879,11839.714285714286
2020-07-08,16063,1476,22,17561,12203
2020-07-09,15554,1352,40,16946,12592.285714285714
2020-07-10,15043,1298,35,16376,13632.142857142857
2020-07-11,8875,720,29,9624,14424.714285714286
2020-07-12,5835,498,7,6340,14693.714285714286
2020-07-13,20903,1543,57,22503,15318.42857142857
2020-07-14,18326,1494,34,19854,15600.57142857143
2020-07-15,16609,1319,22,17950,15656.142857142857
2020-07-16,13852,1233,14,15099,15392.285714285714
2020-07-17,14986,1192,15,16193,15366.142857142857
2020-07-18,7577,766,14,8357,15185.142857142857
2020-07-19,5030,561,12,5603,15079.857142857143
2020-07-20,20392,1704,31,22127,15026.142857142857
2020-07-21,16842,1461,35,18338,14809.57142857143
2020-07-22,13841,1423,22,15286,14429
2020-07-23,14410,1412,36,15858,14537.42857142857
2020-07-24,14778,1325,29,16132,14528.714285714286
2020-07-25,7677,654,10,8341,14526.42857142857
2020-07-26,5435,493,15,5943,14575
2020-07-27,18820,1556,40,20416,14330.57142857143
2020-07-28,17811,1348,30,19189,14452.142857142857
2020-07-29,13938,1435,28,15401,14468.57142857143
2020-07-30,12780,1249,20,14049,14210.142857142857
2020-07-31,13298,1129,10,14437,13968
2020-08-01,7274,615,20,7909,13906.285714285714
2020-08-02,5401,617,22,6040,13920.142857142857
2020-08-03,20155,1665,44,21864,14127
2020-08-04,16263,1447,29,17739,13919.857142857143
2020-08-05,13462,1370,21,14853,13841.57142857143
2020-08-06,12684,1147,11,13842,13812
2020-08-07,13709,1102,22,14833,13868.57142857143
2020-08-08,6748,708,8,7464,13805
2020-08-09,5228,474,7,5709,13757.714285714286
2020-08-10,17242,1445,22,18709,13307
2020-08-11,15089,1300,25,16414,13117.714285714286
2020-08-12,13423,1383,31,14837,13115.42857142857
2020-08-13,13063,1129,17,14209,13167.857142857143
2020-08-14,13463,1116,16,14595,13133.857142857143
2020-08-15,6034,623,12,6669,13020.285714285714
2020-08-16,4856,538,13,5407,12977.142857142857
2020-08-17,13983,1491,26,15500,12518.714285714286
2020-08-18,14274,1207,21,15502,12388.42857142857
2020-08-19,12485,1254,25,13764,12235.142857142857
2020-08-20,11564,1194,18,12776,12030.42857142857
2020-08-21,11884,1079,14,12977,11799.285714285714
2020-08-22,5482,548,6,6036,11708.857142857143
2020-08-23,3560,503,15,4078,11519
2020-08-24,13941,1506,28,15475,11515.42857142857
2020-08-25,14041,1315,24,15380,11498
2020-08-26,12391,1459,27,13877,11514.142857142857
2020-08-27,12066,1277,17,13360,11597.57142857143
2020-08-28,11771,1255,25,13051,11608.142857142857
2020-08-29,5599,684,13,6296,11645.285714285714
2020-08-30,3996,559,6,4561,11714.285714285714
2020-08-31,13629,1627,42,15298,11689
2020-09-01,13523,1432,24,14979,11631.714285714286
2020-09-02,13886,1487,40,15413,11851.142857142857
2020-09-03,14176,1326,69,15571,12167
2020-09-04,13496,1260,12,14768,12412.285714285714
2020-09-05,6549,727,10,7286,12553.714285714286
2020-09-06,4973,589,35,5597,12701.714285714286
2020-09-07,5858,658,5,6521,11447.857142857143
2020-09-08,19208,1945,31,21184,12334.285714285714
2020-09-09,14113,1705,23,15841,12395.42857142857
2020-09-10,13297,1473,15,14785,12283.142857142857
2020-09-11,12675,1234,18,13927,12163
2020-09-12,5032,535,6,5573,11918.285714285714
