report_date,pcr_neg,pcr_pos,pcr_int,pcr_total,pcr_avg
2020-03-16,409,30,0,439,NA
2020-03-17,635,50,0,685,NA
2020-03-18,737,57,2,796,NA
2020-03-19,1057,71,1,1129,NA
2020-03-20,1076,104,2,1182,NA
2020-03-21,741,82,2,825,NA
2020-03-22,626,80,0,706,823.1428571428571
2020-03-23,1629,176,4,1809,1018.8571428571429
2020-03-24,1850,214,0,2064,1215.857142857143
2020-03-25,2221,224,6,2451,1452.2857142857142
2020-03-26,2173,258,1,2432,1638.4285714285713
2020-03-27,1883,296,0,2179,1780.857142857143
2020-03-28,1092,193,2,1287,1846.857142857143
2020-03-29,751,139,0,890,1873.142857142857
2020-03-30,2426,361,0,2787,2012.857142857143
2020-03-31,2199,301,1,2501,2075.285714285714
2020-04-01,2046,274,2,2322,2056.8571428571427
2020-04-02,1888,292,3,2183,2021.2857142857142
2020-04-03,1732,251,2,1985,1993.5714285714287
2020-04-04,950,145,2,1097,1966.4285714285713
2020-04-05,784,113,3,900,1967.857142857143
2020-04-06,2417,319,7,2743,1961.5714285714287
2020-04-07,2081,242,2,2325,1936.4285714285713
2020-04-08,2060,252,1,2313,1935.142857142857
2020-04-09,1766,215,4,1985,1906.857142857143
2020-04-10,1986,241,5,2232,1942.142857142857
2020-04-11,851,105,1,957,1922.142857142857
2020-04-12,694,101,3,798,1907.5714285714287
2020-04-13,1977,287,4,2268,1839.7142857142858
2020-04-14,1959,235,6,2200,1821.857142857143
2020-04-15,1831,241,4,2076,1788
2020-04-16,1840,234,4,2078,1801.2857142857142
2020-04-17,2171,202,4,2377,1822
2020-04-18,1080,174,0,1254,1864.4285714285713
2020-04-19,830,150,2,982,1890.7142857142858
2020-04-20,2443,315,10,2768,1962.142857142857
2020-04-21,2297,274,9,2580,2016.4285714285713
2020-04-22,2704,279,6,2989,2146.8571428571427
2020-04-23,2640,281,9,2930,2268.5714285714284
2020-04-24,2470,263,17,2750,2321.8571428571427
2020-04-25,1172,139,1,1312,2330.1428571428573
2020-04-26,1042,90,1,1133,2351.714285714286
2020-04-27,3787,349,7,4143,2548.1428571428573
2020-04-28,4566,430,14,5010,2895.285714285714
2020-04-29,4569,379,9,4957,3176.4285714285716
2020-04-30,3846,335,11,4192,3356.714285714286
2020-05-01,4225,340,13,4578,3617.8571428571427
2020-05-02,1581,92,2,1675,3669.714285714286
2020-05-03,1097,90,2,1189,3677.714285714286
2020-05-04,3859,304,14,4177,3682.5714285714284
2020-05-05,4620,325,17,4962,3675.714285714286
2020-05-06,4078,260,8,4346,3588.4285714285716
2020-05-07,3769,181,10,3960,3555.285714285714
2020-05-08,4391,178,6,4575,3554.8571428571427
2020-05-09,2099,133,4,2236,3635
2020-05-10,1253,76,0,1329,3655
2020-05-11,5060,261,11,5332,3820
2020-05-12,5270,233,7,5510,3898.285714285714
2020-05-13,5346,339,9,5694,4090.8571428571427
2020-05-14,4866,266,3,5135,4258.714285714285
2020-05-15,5686,254,13,5953,4455.571428571428
2020-05-16,3882,99,2,3983,4705.142857142857
2020-05-17,2765,125,3,2893,4928.571428571428
2020-05-18,6445,283,6,6734,5128.857142857143
2020-05-19,5784,298,6,6088,5211.428571428572
2020-05-20,5748,307,3,6058,5263.428571428572
2020-05-21,5586,320,10,5916,5375
2020-05-22,6899,251,9,7159,5547.285714285715
2020-05-23,2987,109,2,3098,5420.857142857143
2020-05-24,2458,82,3,2543,5370.857142857143
2020-05-25,2348,94,2,2444,4758
2020-05-26,12657,362,13,13032,5750
2020-05-27,11515,357,10,11882,6582
2020-05-28,10210,271,7,10488,7235.142857142857
2020-05-29,9487,271,7,9765,7607.428571428572
2020-05-30,4330,327,4,4661,7830.714285714285
2020-05-31,2767,215,3,2985,7893.857142857143
2020-06-01,10085,354,81,10520,9047.57142857143
2020-06-02,8405,283,13,8701,8428.857142857143
2020-06-03,8777,281,10,9068,8026.857142857143
2020-06-04,7640,309,18,7967,7666.714285714285
2020-06-05,8701,322,9,9032,7562
2020-06-06,3316,125,3,3444,7388.142857142857
2020-06-07,2322,81,0,2403,7305
2020-06-08,9499,368,8,9875,7212.857142857143
2020-06-09,10173,386,2,10561,7478.571428571428
2020-06-10,9897,378,10,10285,7652.428571428572
2020-06-11,7936,461,8,8405,7715
2020-06-12,8455,389,10,8854,7689.571428571428
2020-06-13,3820,171,6,3997,7768.571428571428
2020-06-14,2601,124,1,2726,7814.714285714285
2020-06-15,13854,520,43,14417,8463.57142857143
2020-06-16,11656,577,112,12345,8718.42857142857
2020-06-17,9771,513,19,10303,8721
2020-06-18,9500,666,41,10207,8978.42857142857
2020-06-19,10500,492,18,11010,9286.42857142857
2020-06-20,4480,258,11,4749,9393.857142857143
2020-06-21,2878,234,0,3112,9449
2020-06-22,15404,720,92,16216,9706
2020-06-23,11698,667,27,12392,9712.714285714286
2020-06-24,11017,746,29,11792,9925.42857142857
2020-06-25,9448,654,17,10119,9912.857142857143
2020-06-26,11777,667,10,12454,10119.142857142857
2020-06-27,5570,427,3,6000,10297.857142857143
2020-06-28,4620,291,2,4913,10555.142857142857
2020-06-29,17542,999,33,18574,10892
2020-06-30,14256,1010,15,15281,11304.714285714286
2020-07-01,13511,1069,25,14605,11706.57142857143
2020-07-02,12601,1102,14,13717,12220.57142857143
2020-07-03,8025,728,15,8768,11694
2020-07-04,3629,357,6,3992,11407.142857142857
2020-07-05,4042,380,0,4422,11337
2020-07-06,16220,1294,13,17527,11187.42857142857
2020-07-07,15914,1369,18,17301,11476
2020-07-08,15613,1473,22,17108,11833.57142857143
2020-07-09,15387,1347,40,16774,12270.285714285714
2020-07-10,14958,1295,36,16289,13344.714285714286
2020-07-11,8862,720,28,9610,14147.285714285714
2020-07-12,5810,495,7,6312,14417.285714285714
2020-07-13,20874,1541,55,22470,15123.42857142857
2020-07-14,18298,1491,34,19823,15483.714285714286
2020-07-15,16591,1326,22,17939,15602.42857142857
2020-07-16,13718,1230,14,14962,15343.57142857143
2020-07-17,14979,1189,15,16183,15328.42857142857
2020-07-18,7554,766,14,8334,15146.142857142857
2020-07-19,5018,556,12,5586,15042.42857142857
2020-07-20,20351,1706,31,22088,14987.857142857143
2020-07-21,16812,1457,35,18304,14770.857142857143
2020-07-22,13809,1417,22,15248,14386.42857142857
2020-07-23,14390,1416,36,15842,14512.142857142857
2020-07-24,14759,1322,27,16108,14501.42857142857
2020-07-25,7660,652,10,8322,14499.714285714286
2020-07-26,5413,491,15,5919,14547.285714285714
2020-07-27,18786,1555,40,20381,14303.42857142857
2020-07-28,17782,1356,30,19168,14426.857142857143
2020-07-29,13924,1437,28,15389,14447
2020-07-30,12756,1251,19,14026,14187.57142857143
2020-07-31,13252,1127,10,14389,13942
2020-08-01,7254,612,20,7886,13879.714285714286
2020-08-02,5381,615,22,6018,13893.857142857143
2020-08-03,20136,1676,44,21856,14104.57142857143
2020-08-04,16252,1433,31,17716,13897.142857142857
2020-08-05,13402,1374,20,14796,13812.42857142857
2020-08-06,12552,1149,10,13711,13767.42857142857
2020-08-07,13723,1115,21,14859,13834.57142857143
2020-08-08,6718,707,10,7435,13770.142857142857
2020-08-09,5182,478,9,5669,13720.285714285714
2020-08-10,17267,1443,22,18732,13274
2020-08-11,14515,1298,25,15838,13005.714285714286
2020-08-12,12206,1384,33,13623,12838.142857142857
2020-08-13,13074,1120,16,14210,12909.42857142857
2020-08-14,13577,1114,15,14706,12887.57142857143
2020-08-15,5907,621,10,6538,12759.42857142857
2020-08-16,4838,533,13,5384,12718.714285714286
2020-08-17,13451,1492,24,14967,12180.857142857143
2020-08-18,13944,1205,20,15169,12085.285714285714
2020-08-19,12048,1245,21,13314,12041.142857142857
2020-08-20,10332,1211,22,11565,11663.285714285714
2020-08-21,10493,1088,11,11592,11218.42857142857
2020-08-22,4949,566,5,5520,11073
2020-08-23,3552,510,18,4080,10886.714285714286
2020-08-24,13559,1529,24,15112,10907.42857142857
2020-08-25,13658,1332,24,15014,10885.285714285714
2020-08-26,12186,1468,21,13675,10936.857142857143
2020-08-27,11453,1282,14,12749,11106
2020-08-28,11214,1295,21,12530,11240
2020-08-29,4507,710,11,5228,11198.285714285714
2020-08-30,3457,570,12,4039,11192.42857142857
2020-08-31,12261,1652,32,13945,11025.714285714286
2020-09-01,10391,1391,23,11805,10567.285714285714
2020-09-02,11134,1459,31,12624,10417.142857142857
2020-09-03,10084,1157,65,11306,10211
2020-09-04,7945,993,10,8948,9699.285714285714
2020-09-05,3181,491,9,3681,9478.285714285714
