report_date,pcr_neg,pcr_pos,pcr_int,pcr_total,pcr_avg
2020-03-16,409,30,0,439,NA
2020-03-17,635,50,0,685,NA
2020-03-18,738,57,2,797,NA
2020-03-19,1057,71,1,1129,NA
2020-03-20,1076,103,2,1181,NA
2020-03-21,741,82,2,825,NA
2020-03-22,626,79,0,705,823
2020-03-23,1630,176,4,1810,1018.8571428571429
2020-03-24,1850,214,0,2064,1215.857142857143
2020-03-25,2221,224,6,2451,1452.142857142857
2020-03-26,2172,258,1,2431,1638.142857142857
2020-03-27,1883,296,0,2179,1780.7142857142858
2020-03-28,1092,193,2,1287,1846.7142857142858
2020-03-29,751,139,0,890,1873.142857142857
2020-03-30,2426,361,0,2787,2012.7142857142858
2020-03-31,2198,301,1,2500,2075
2020-04-01,2046,273,2,2321,2056.4285714285716
2020-04-02,1888,292,3,2183,2021
2020-04-03,1733,250,2,1985,1993.2857142857142
2020-04-04,952,146,2,1100,1966.5714285714287
2020-04-05,784,113,3,900,1968
2020-04-06,2417,320,7,2744,1961.857142857143
2020-04-07,2081,242,2,2325,1936.857142857143
2020-04-08,2060,252,1,2313,1935.7142857142858
2020-04-09,1766,218,4,1988,1907.857142857143
2020-04-10,1986,241,5,2232,1943.142857142857
2020-04-11,851,107,1,959,1923
2020-04-12,694,102,3,799,1908.5714285714287
2020-04-13,1978,287,4,2269,1840.7142857142858
2020-04-14,1964,235,6,2205,1823.5714285714287
2020-04-15,1842,242,4,2088,1791.4285714285713
2020-04-16,1846,235,4,2085,1805.2857142857142
2020-04-17,2177,203,4,2384,1827
2020-04-18,1085,173,0,1258,1869.7142857142858
2020-04-19,832,151,2,985,1896.2857142857142
2020-04-20,2459,317,10,2786,1970.142857142857
2020-04-21,2303,275,9,2587,2024.7142857142858
2020-04-22,2709,279,6,2994,2154.1428571428573
2020-04-23,2658,281,9,2948,2277.4285714285716
2020-04-24,2481,263,17,2761,2331.285714285714
2020-04-25,1179,139,1,1319,2340
2020-04-26,1048,90,1,1139,2362
2020-04-27,3790,350,7,4147,2556.4285714285716
2020-04-28,4575,431,14,5020,2904
2020-04-29,4622,380,9,5011,3192.1428571428573
2020-04-30,3870,336,11,4217,3373.4285714285716
2020-05-01,4246,339,13,4598,3635.8571428571427
2020-05-02,1587,91,2,1680,3687.4285714285716
2020-05-03,1105,90,2,1197,3695.714285714286
2020-05-04,3873,304,14,4191,3702
2020-05-05,4636,325,17,4978,3696
2020-05-06,4091,259,8,4358,3602.714285714286
2020-05-07,3784,182,10,3976,3568.285714285714
2020-05-08,4408,178,6,4592,3567.4285714285716
2020-05-09,2146,133,4,2283,3653.5714285714284
2020-05-10,1266,76,0,1342,3674.285714285714
2020-05-11,5082,262,11,5355,3840.5714285714284
2020-05-12,5279,234,7,5520,3918
2020-05-13,5373,343,9,5725,4113.285714285715
2020-05-14,4880,265,4,5149,4280.857142857143
2020-05-15,5707,255,14,5976,4478.571428571428
2020-05-16,3891,100,2,3993,4722.857142857143
2020-05-17,2773,125,3,2901,4945.571428571428
2020-05-18,6479,282,6,6767,5147.285714285715
2020-05-19,5825,299,6,6130,5234.428571428572
2020-05-20,5840,307,4,6151,5295.285714285715
2020-05-21,5621,320,10,5951,5409.857142857143
2020-05-22,6930,252,9,7191,5583.428571428572
2020-05-23,2995,109,2,3106,5456.714285714285
2020-05-24,2461,82,3,2546,5406
2020-05-25,2362,94,2,2458,4790.428571428572
2020-05-26,12719,363,13,13095,5785.428571428572
2020-05-27,11593,356,9,11958,6615
2020-05-28,10309,271,7,10587,7277.285714285715
2020-05-29,9521,272,7,9800,7650
2020-05-30,4341,323,4,4668,7873.142857142857
2020-05-31,2780,215,3,2998,7937.714285714285
2020-06-01,10167,355,81,10603,9101.285714285714
2020-06-02,8530,285,13,8828,8491.714285714286
2020-06-03,8819,283,10,9112,8085.142857142857
2020-06-04,7713,310,18,8041,7721.428571428572
2020-06-05,8724,321,9,9054,7614.857142857143
2020-06-06,3373,125,3,3501,7448.142857142857
2020-06-07,2339,81,0,2420,7365.571428571428
2020-06-08,9587,369,9,9965,7274.428571428572
2020-06-09,10192,386,2,10580,7524.714285714285
2020-06-10,9996,378,10,10384,7706.428571428572
2020-06-11,7985,617,8,8610,7787.714285714285
2020-06-12,8496,390,10,8896,7765.142857142857
2020-06-13,3837,171,6,4014,7838.428571428572
2020-06-14,2606,124,1,2731,7882.857142857143
2020-06-15,13928,521,44,14493,8529.714285714286
2020-06-16,11690,576,111,12377,8786.42857142857
2020-06-17,9847,513,19,10379,8785.714285714286
2020-06-18,9554,664,41,10259,9021.285714285714
2020-06-19,10551,493,17,11061,9330.57142857143
2020-06-20,4494,258,11,4763,9437.57142857143
2020-06-21,2900,234,0,3134,9495.142857142857
2020-06-22,15729,725,92,16546,9788.42857142857
2020-06-23,12005,674,26,12705,9835.285714285714
2020-06-24,11322,742,29,12093,10080.142857142857
2020-06-25,9759,659,16,10434,10105.142857142857
2020-06-26,12032,667,9,12708,10340.42857142857
2020-06-27,5668,425,3,6096,10530.857142857143
2020-06-28,4656,291,2,4949,10790.142857142857
2020-06-29,17968,1002,33,19003,11141.142857142857
2020-06-30,14624,1010,16,15650,11561.857142857143
2020-07-01,13933,1081,25,15039,11982.714285714286
2020-07-02,13112,1109,14,14235,12525.714285714286
2020-07-03,8375,733,15,9123,12013.57142857143
2020-07-04,3710,357,6,4073,11724.57142857143
2020-07-05,4079,380,0,4459,11654.57142857143
2020-07-06,16817,1307,12,18136,11530.714285714286
2020-07-07,16483,1386,19,17888,11850.42857142857
2020-07-08,16083,1481,22,17586,12214.285714285714
2020-07-09,15584,1356,40,16980,12606.42857142857
2020-07-10,15089,1301,36,16426,13649.714285714286
2020-07-11,8906,723,29,9658,14447.57142857143
2020-07-12,5835,497,7,6339,14716.142857142857
2020-07-13,20929,1544,57,22530,15343.857142857143
2020-07-14,18360,1500,34,19894,15630.42857142857
2020-07-15,16675,1321,22,18018,15692.142857142857
2020-07-16,13910,1235,14,15159,15432
2020-07-17,15031,1195,15,16241,15405.57142857143
2020-07-18,7572,767,15,8354,15219.285714285714
2020-07-19,5037,562,12,5611,15115.285714285714
2020-07-20,20391,1705,31,22127,15057.714285714286
2020-07-21,16851,1462,35,18348,14836.857142857143
2020-07-22,13827,1417,22,15266,14443.714285714286
2020-07-23,14425,1413,37,15875,14546
2020-07-24,14789,1317,29,16135,14530.857142857143
2020-07-25,7680,654,10,8344,14529.42857142857
2020-07-26,5436,494,15,5945,14577.142857142857
2020-07-27,18825,1553,40,20418,14333
2020-07-28,17817,1350,30,19197,14454.285714285714
2020-07-29,13937,1439,29,15405,14474.142857142857
2020-07-30,12802,1252,19,14073,14216.714285714286
2020-07-31,13332,1138,10,14480,13980.285714285714
2020-08-01,7277,612,20,7909,13918.142857142857
2020-08-02,5400,622,23,6045,13932.42857142857
2020-08-03,20149,1670,45,21864,14139
2020-08-04,16260,1438,28,17726,13928.857142857143
2020-08-05,13446,1373,20,14839,13848
2020-08-06,12625,1144,12,13781,13806.285714285714
2020-08-07,13629,1100,22,14751,13845
2020-08-08,6730,692,8,7430,13776.57142857143
2020-08-09,5201,474,8,5683,13724.857142857143
2020-08-10,17178,1438,21,18637,13263.857142857143
2020-08-11,15045,1302,24,16371,13070.285714285714
2020-08-12,13375,1371,29,14775,13061.142857142857
2020-08-13,12999,1138,17,14154,13114.42857142857
2020-08-14,13422,1117,19,14558,13086.857142857143
2020-08-15,6013,624,9,6646,12974.857142857143
2020-08-16,4856,534,15,5405,12935.142857142857
2020-08-17,13967,1486,25,15478,12483.857142857143
2020-08-18,14219,1209,17,15445,12351.57142857143
2020-08-19,12433,1220,19,13672,12194
2020-08-20,11518,1202,19,12739,11991.857142857143
2020-08-21,11812,1075,12,12899,11754.857142857143
2020-08-22,5463,536,7,6006,11663.42857142857
2020-08-23,3534,509,15,4058,11471
2020-08-24,13782,1490,25,15297,11445.142857142857
2020-08-25,13949,1302,21,15272,11420.42857142857
2020-08-26,12285,1459,27,13771,11434.57142857143
2020-08-27,11984,1268,15,13267,11510
2020-08-28,11673,1255,23,12951,11517.42857142857
2020-08-29,5556,683,12,6251,11552.42857142857
2020-08-30,3969,561,7,4537,11620.857142857143
2020-08-31,13547,1615,33,15195,11606.285714285714
2020-09-01,13411,1427,24,14862,11547.714285714286
2020-09-02,13730,1455,35,15220,11754.714285714286
2020-09-03,14212,1332,69,15613,12089.857142857143
2020-09-04,14054,1289,13,15356,12433.42857142857
2020-09-05,6525,716,9,7250,12576.142857142857
2020-09-06,4948,592,33,5573,12724.142857142857
2020-09-07,5865,665,4,6534,11486.857142857143
2020-09-08,19406,1975,27,21408,12422
2020-09-09,14562,1820,24,16406,12591.42857142857
2020-09-10,14200,1537,18,15755,12611.714285714286
2020-09-11,14987,1404,24,16415,12763
2020-09-12,6827,734,5,7566,12808.142857142857
2020-09-13,4991,566,6,5563,12806.714285714286
2020-09-14,19513,1746,36,21295,14915.42857142857
2020-09-15,16910,1518,24,18452,14493.142857142857
2020-09-16,12431,1289,15,13735,14111.57142857143
2020-09-17,8061,876,15,8952,13139.714285714286
