report_date,pcr_neg,pcr_pos,pcr_int,pcr_total,pcr_avg
2020-03-16,409,30,0,439,NA
2020-03-17,635,50,0,685,NA
2020-03-18,738,57,2,797,NA
2020-03-19,1055,73,1,1129,NA
2020-03-20,1078,101,2,1181,NA
2020-03-21,741,82,2,825,NA
2020-03-22,626,79,0,705,823
2020-03-23,1630,176,4,1810,1018.8571428571429
2020-03-24,1850,214,0,2064,1215.857142857143
2020-03-25,2221,224,6,2451,1452.142857142857
2020-03-26,2172,259,1,2432,1638.2857142857142
2020-03-27,1884,295,0,2179,1780.857142857143
2020-03-28,1092,194,1,1287,1846.857142857143
2020-03-29,751,138,0,889,1873.142857142857
2020-03-30,2429,361,0,2790,2013.142857142857
2020-03-31,2203,301,1,2505,2076.1428571428573
2020-04-01,2046,274,2,2322,2057.714285714286
2020-04-02,1889,290,4,2183,2022.142857142857
2020-04-03,1733,250,2,1985,1994.4285714285713
2020-04-04,952,146,2,1100,1967.7142857142858
2020-04-05,784,113,3,900,1969.2857142857142
2020-04-06,2417,320,7,2744,1962.7142857142858
2020-04-07,2081,242,2,2325,1937
2020-04-08,2060,252,1,2313,1935.7142857142858
2020-04-09,1766,218,4,1988,1907.857142857143
2020-04-10,1986,241,5,2232,1943.142857142857
2020-04-11,851,107,1,959,1923
2020-04-12,694,102,3,799,1908.5714285714287
2020-04-13,1978,287,4,2269,1840.7142857142858
2020-04-14,1966,234,6,2206,1823.7142857142858
2020-04-15,1844,242,4,2090,1791.857142857143
2020-04-16,1845,235,4,2084,1805.5714285714287
2020-04-17,2177,202,4,2383,1827.142857142857
2020-04-18,1084,173,0,1257,1869.7142857142858
2020-04-19,832,151,2,985,1896.2857142857142
2020-04-20,2459,317,10,2786,1970.142857142857
2020-04-21,2301,275,9,2585,2024.2857142857142
2020-04-22,2710,278,6,2994,2153.4285714285716
2020-04-23,2658,280,9,2947,2276.714285714286
2020-04-24,2481,263,17,2761,2330.714285714286
2020-04-25,1181,140,1,1322,2340
2020-04-26,1050,90,1,1141,2362.285714285714
2020-04-27,3790,350,7,4147,2556.714285714286
2020-04-28,4576,430,14,5020,2904.5714285714284
2020-04-29,4621,379,9,5009,3192.4285714285716
2020-04-30,3868,336,11,4215,3373.5714285714284
2020-05-01,4243,340,13,4596,3635.714285714286
2020-05-02,1589,91,2,1682,3687.1428571428573
2020-05-03,1104,90,2,1196,3695
2020-05-04,3874,304,14,4192,3701.4285714285716
2020-05-05,4634,327,17,4978,3695.4285714285716
2020-05-06,4090,259,8,4357,3602.285714285714
2020-05-07,3785,182,10,3977,3568.285714285714
2020-05-08,4408,178,6,4592,3567.714285714286
2020-05-09,2147,133,4,2284,3653.714285714286
2020-05-10,1267,76,0,1343,3674.714285714286
2020-05-11,5082,263,11,5356,3841
2020-05-12,5282,234,7,5523,3918.8571428571427
2020-05-13,5376,342,9,5727,4114.571428571428
2020-05-14,4880,265,4,5149,4282
2020-05-15,5707,256,14,5977,4479.857142857143
2020-05-16,3891,100,2,3993,4724
2020-05-17,2772,125,3,2900,4946.428571428572
2020-05-18,6482,282,6,6770,5148.428571428572
2020-05-19,5825,299,6,6130,5235.142857142857
2020-05-20,5841,306,5,6152,5295.857142857143
2020-05-21,5620,321,9,5950,5410.285714285715
2020-05-22,6929,251,9,7189,5583.428571428572
2020-05-23,2996,109,2,3107,5456.857142857143
2020-05-24,2462,82,3,2547,5406.428571428572
2020-05-25,2362,94,2,2458,4790.428571428572
2020-05-26,12720,364,13,13097,5785.714285714285
2020-05-27,11594,360,9,11963,6615.857142857143
2020-05-28,10307,271,7,10585,7278
2020-05-29,9521,272,7,9800,7651
2020-05-30,4344,324,4,4672,7874.571428571428
2020-05-31,2779,215,3,2997,7938.857142857143
2020-06-01,10169,354,81,10604,9102.57142857143
2020-06-02,8530,284,13,8827,8492.57142857143
2020-06-03,8818,281,10,9109,8084.857142857143
2020-06-04,7711,310,18,8039,7721.142857142857
2020-06-05,8725,321,10,9056,7614.857142857143
2020-06-06,3374,125,3,3502,7447.714285714285
2020-06-07,2339,81,0,2420,7365.285714285715
2020-06-08,9587,367,9,9963,7273.714285714285
2020-06-09,10194,385,2,10581,7524.285714285715
2020-06-10,9996,379,10,10385,7706.571428571428
2020-06-11,10497,617,8,11122,8147
2020-06-12,8495,389,10,8894,8123.857142857143
2020-06-13,3834,172,5,4011,8196.57142857143
2020-06-14,2606,124,1,2731,8241
2020-06-15,13934,520,44,14498,8888.857142857143
2020-06-16,11694,573,114,12381,9146
2020-06-17,9846,512,20,10378,9145
2020-06-18,9554,663,41,10258,9021.57142857143
2020-06-19,10550,491,18,11059,9330.857142857143
2020-06-20,4489,258,11,4758,9437.57142857143
2020-06-21,2901,234,0,3135,9495.285714285714
2020-06-22,15715,722,93,16530,9785.57142857143
2020-06-23,12000,671,26,12697,9830.714285714286
2020-06-24,11311,746,29,12086,10074.714285714286
2020-06-25,9742,657,16,10415,10097.142857142857
2020-06-26,12029,665,10,12704,10332.142857142857
2020-06-27,5667,425,3,6095,10523.142857142857
2020-06-28,4656,295,2,4953,10782.857142857143
2020-06-29,17973,1003,33,19009,11137
2020-06-30,14632,1014,16,15662,11560.57142857143
2020-07-01,13931,1077,24,15032,11981.42857142857
2020-07-02,13101,1103,14,14218,12524.714285714286
2020-07-03,8385,736,14,9135,12014.857142857143
2020-07-04,3714,355,6,4075,11726.285714285714
2020-07-05,4080,379,0,4459,11655.714285714286
2020-07-06,16815,1307,13,18135,11530.857142857143
2020-07-07,16490,1387,19,17896,11850
2020-07-08,16105,1479,22,17606,12217.714285714286
2020-07-09,15582,1358,40,16980,12612.285714285714
2020-07-10,15085,1299,36,16420,13653
2020-07-11,8904,726,29,9659,14450.714285714286
2020-07-12,5838,497,7,6342,14719.714285714286
2020-07-13,20930,1548,55,22533,15348
2020-07-14,18351,1488,34,19873,15630.42857142857
2020-07-15,16692,1315,22,18029,15690.857142857143
2020-07-16,13902,1236,14,15152,15429.714285714286
2020-07-17,15025,1193,14,16232,15402.857142857143
2020-07-18,7572,765,15,8352,15216.142857142857
2020-07-19,5029,560,12,5601,15110.285714285714
2020-07-20,20392,1703,31,22126,15052.142857142857
2020-07-21,16861,1461,35,18357,14835.57142857143
2020-07-22,13853,1416,22,15291,14444.42857142857
2020-07-23,14427,1411,37,15875,14547.714285714286
2020-07-24,14792,1318,27,16137,14534.142857142857
2020-07-25,7678,652,10,8340,14532.42857142857
2020-07-26,5434,494,15,5943,14581.285714285714
2020-07-27,18945,1557,40,20542,14355
2020-07-28,17864,1354,30,19248,14482.285714285714
2020-07-29,14093,1439,28,15560,14520.714285714286
2020-07-30,12901,1243,19,14163,14276.142857142857
2020-07-31,13454,1133,10,14597,14056.142857142857
2020-08-01,7319,614,20,7953,14000.857142857143
2020-08-02,5440,619,22,6081,14020.57142857143
2020-08-03,20429,1667,43,22139,14248.714285714286
2020-08-04,16868,1439,26,18333,14118
2020-08-05,14578,1358,19,15955,14174.42857142857
2020-08-06,13726,1139,10,14875,14276.142857142857
2020-08-07,14126,1103,24,15253,14369.857142857143
2020-08-08,6730,697,10,7437,14296.142857142857
2020-08-09,5237,478,8,5723,14245
2020-08-10,17578,1450,19,19047,13803.285714285714
2020-08-11,15757,1300,28,17085,13625
2020-08-12,14056,1379,30,15465,13555
2020-08-13,13095,1130,16,14241,13464.42857142857
2020-08-14,13759,1121,16,14896,13413.42857142857
2020-08-15,6177,626,10,6813,13324.285714285714
2020-08-16,4966,526,12,5504,13293
2020-08-17,14873,1481,22,16376,12911.42857142857
2020-08-18,15221,1208,29,16458,12821.857142857143
2020-08-19,13312,1228,22,14562,12692.857142857143
2020-08-20,12274,1208,20,13502,12587.285714285714
2020-08-21,12359,1059,9,13427,12377.42857142857
2020-08-22,5614,544,8,6166,12285
2020-08-23,3995,492,18,4505,12142.285714285714
2020-08-24,14686,1488,28,16202,12117.42857142857
2020-08-25,13894,1340,24,15258,11946
2020-08-26,12554,1433,27,14014,11867.714285714286
2020-08-27,12848,1264,15,14127,11957
2020-08-28,11772,1240,21,13033,11900.714285714286
2020-08-29,6071,676,10,6757,11985.142857142857
2020-08-30,4246,556,8,4810,12028.714285714286
2020-08-31,13892,1618,34,15544,11934.714285714286
2020-09-01,13372,1434,20,14826,11873
2020-09-02,13723,1460,32,15215,12044.57142857143
2020-09-03,14118,1325,61,15504,12241.285714285714
2020-09-04,14017,1286,14,15317,12567.57142857143
2020-09-05,6547,730,9,7286,12643.142857142857
2020-09-06,4951,596,34,5581,12753.285714285714
2020-09-07,5859,655,6,6520,11464.142857142857
2020-09-08,19401,1951,38,21390,12401.857142857143
2020-09-09,14547,1819,30,16396,12570.57142857143
2020-09-10,14159,1520,19,15698,12598.285714285714
2020-09-11,14960,1409,24,16393,12752
2020-09-12,6794,730,6,7530,12786.857142857143
2020-09-13,5290,575,5,5870,12828.142857142857
2020-09-14,19743,1781,40,21564,14977.285714285714
2020-09-15,17306,1624,28,18958,14629.857142857143
2020-09-16,14080,1498,17,15595,14515.42857142857
2020-09-17,14009,1484,23,15516,14489.42857142857
2020-09-18,13475,1318,12,14805,14262.57142857143
2020-09-19,7071,705,14,7790,14299.714285714286
2020-09-20,3736,511,4,4251,14068.42857142857
2020-09-21,10990,1143,13,12146,12723
