report_date,pcr_neg,pcr_pos,pcr_int,pcr_total,pcr_avg
2020-03-16,409,30,0,439,NA
2020-03-17,635,50,0,685,NA
2020-03-18,737,57,2,796,NA
2020-03-19,1056,71,1,1128,NA
2020-03-20,1076,104,2,1182,NA
2020-03-21,741,82,2,825,NA
2020-03-22,626,79,0,705,822.8571428571429
2020-03-23,1628,176,4,1808,1018.4285714285714
2020-03-24,1850,214,0,2064,1215.4285714285713
2020-03-25,2205,224,6,2435,1449.5714285714287
2020-03-26,2166,258,1,2425,1634.857142857143
2020-03-27,1841,296,0,2137,1771.2857142857142
2020-03-28,1090,193,2,1285,1837
2020-03-29,747,139,0,886,1862.857142857143
2020-03-30,2407,361,0,2768,2000
2020-03-31,2167,301,1,2469,2057.8571428571427
2020-04-01,2020,274,2,2296,2038
2020-04-02,1886,292,3,2181,2003.142857142857
2020-04-03,1731,250,2,1983,1981.142857142857
2020-04-04,950,145,2,1097,1954.2857142857142
2020-04-05,784,113,3,900,1956.2857142857142
2020-04-06,2417,319,7,2743,1952.7142857142858
2020-04-07,2081,242,2,2325,1932.142857142857
2020-04-08,2060,252,1,2313,1934.5714285714287
2020-04-09,1766,214,4,1984,1906.4285714285713
2020-04-10,1986,241,5,2232,1942
2020-04-11,851,105,1,957,1922
2020-04-12,694,98,3,795,1907
2020-04-13,1977,282,4,2263,1838.4285714285713
2020-04-14,1959,235,6,2200,1820.5714285714287
2020-04-15,1831,241,4,2076,1786.7142857142858
2020-04-16,1840,234,4,2078,1800.142857142857
2020-04-17,2171,202,4,2377,1820.857142857143
2020-04-18,1080,173,0,1253,1863.142857142857
2020-04-19,830,150,2,982,1889.857142857143
2020-04-20,2443,315,10,2768,1962
2020-04-21,2297,274,9,2580,2016.2857142857142
2020-04-22,2704,279,6,2989,2146.714285714286
2020-04-23,2639,281,9,2929,2268.285714285714
2020-04-24,2470,263,17,2750,2321.5714285714284
2020-04-25,1172,139,1,1312,2330
2020-04-26,1042,90,1,1133,2351.5714285714284
2020-04-27,3780,349,7,4136,2547
2020-04-28,4564,429,14,5007,2893.714285714286
2020-04-29,4555,379,9,4943,3172.8571428571427
2020-04-30,3839,334,11,4184,3352.1428571428573
2020-05-01,4216,338,13,4567,3611.714285714286
2020-05-02,1577,92,2,1671,3663
2020-05-03,1089,89,2,1180,3669.714285714286
2020-05-04,3856,304,14,4174,3675.1428571428573
2020-05-05,4618,326,17,4961,3668.5714285714284
2020-05-06,4075,260,8,4343,3582.8571428571427
2020-05-07,3768,182,10,3960,3550.8571428571427
2020-05-08,4390,178,6,4574,3551.8571428571427
2020-05-09,2099,133,4,2236,3632.5714285714284
2020-05-10,1253,76,0,1329,3653.8571428571427
2020-05-11,5055,261,11,5327,3818.5714285714284
2020-05-12,5257,233,7,5497,3895.1428571428573
2020-05-13,5340,339,9,5688,4087.285714285714
2020-05-14,4860,266,3,5129,4254.285714285715
2020-05-15,5682,255,13,5950,4450.857142857143
2020-05-16,3882,99,2,3983,4700.428571428572
2020-05-17,2765,125,3,2893,4923.857142857143
2020-05-18,6444,283,6,6733,5124.714285714285
2020-05-19,5782,298,6,6086,5208.857142857143
2020-05-20,5745,307,3,6055,5261.285714285715
2020-05-21,5582,320,10,5912,5373.142857142857
2020-05-22,6892,251,9,7152,5544.857142857143
2020-05-23,2987,109,2,3098,5418.428571428572
2020-05-24,2457,82,3,2542,5368.285714285715
2020-05-25,2348,94,2,2444,4755.571428571428
2020-05-26,12653,362,13,13028,5747.285714285715
2020-05-27,11511,356,10,11877,6579
2020-05-28,10206,271,7,10484,7232.142857142857
2020-05-29,9476,271,7,9754,7603.857142857143
2020-05-30,4329,327,4,4660,7827
2020-05-31,2767,215,3,2985,7890.285714285715
2020-06-01,10085,354,81,10520,9044
2020-06-02,8397,283,13,8693,8424.714285714286
2020-06-03,8771,282,10,9063,8022.714285714285
2020-06-04,7638,309,18,7965,7662.857142857143
2020-06-05,8692,322,9,9023,7558.428571428572
2020-06-06,3315,125,3,3443,7384.571428571428
2020-06-07,2322,81,0,2403,7301.428571428572
2020-06-08,9491,368,8,9867,7208.142857142857
2020-06-09,10174,386,2,10562,7475.142857142857
2020-06-10,9895,378,10,10283,7649.428571428572
2020-06-11,7935,446,7,8388,7709.857142857143
2020-06-12,8451,389,10,8850,7685.142857142857
2020-06-13,3820,171,6,3997,7764.285714285715
2020-06-14,2601,124,1,2726,7810.428571428572
2020-06-15,13848,520,43,14411,8459.57142857143
2020-06-16,11653,577,112,12342,8713.857142857143
2020-06-17,9770,513,19,10302,8716.57142857143
2020-06-18,9494,666,41,10201,8975.57142857143
2020-06-19,10492,492,18,11002,9283
2020-06-20,4480,258,11,4749,9390.42857142857
2020-06-21,2877,234,0,3111,9445.42857142857
2020-06-22,15400,720,92,16212,9702.714285714286
2020-06-23,11692,668,27,12387,9709.142857142857
2020-06-24,11012,746,29,11787,9921.285714285714
2020-06-25,9444,655,16,10115,9909
2020-06-26,11770,667,10,12447,10115.42857142857
2020-06-27,5562,428,3,5993,10293.142857142857
2020-06-28,4619,288,2,4909,10550
2020-06-29,17535,998,33,18566,10886.285714285714
2020-06-30,14241,1007,15,15263,11297.142857142857
2020-07-01,13502,1068,25,14595,11698.285714285714
2020-07-02,12584,1102,14,13700,12210.42857142857
2020-07-03,8005,720,15,8740,11680.857142857143
2020-07-04,3627,359,5,3991,11394.857142857143
2020-07-05,4039,379,0,4418,11324.714285714286
2020-07-06,16031,1295,13,17339,11149.42857142857
2020-07-07,15813,1340,18,17171,11422
2020-07-08,15365,1463,21,16849,11744
2020-07-09,15258,1342,40,16640,12164
2020-07-10,14909,1288,36,16233,13234.42857142857
2020-07-11,8709,713,28,9450,14014.285714285714
2020-07-12,5791,497,7,6295,14282.42857142857
2020-07-13,20707,1536,53,22296,14990.57142857143
2020-07-14,18070,1458,34,19562,15332.142857142857
2020-07-15,16333,1278,22,17633,15444.142857142857
2020-07-16,13626,1226,15,14867,15190.857142857143
2020-07-17,14640,1191,15,15846,15135.57142857143
2020-07-18,7541,763,14,8318,14973.857142857143
2020-07-19,5010,555,12,5577,14871.285714285714
2020-07-20,20192,1701,32,21925,14818.285714285714
2020-07-21,16719,1455,34,18208,14624.857142857143
2020-07-22,13644,1414,22,15080,14260.142857142857
2020-07-23,14256,1403,35,15694,14378.285714285714
2020-07-24,14528,1325,28,15881,14383.285714285714
2020-07-25,7642,651,10,8303,14381.142857142857
2020-07-26,5403,490,15,5908,14428.42857142857
2020-07-27,18599,1550,40,20189,14180.42857142857
2020-07-28,17479,1331,31,18841,14270.857142857143
2020-07-29,13646,1422,29,15097,14273.285714285714
2020-07-30,12506,1242,20,13768,13998.142857142857
2020-07-31,12968,1127,10,14105,13744.42857142857
2020-08-01,7233,612,20,7865,13681.857142857143
2020-08-02,5360,614,22,5996,13694.42857142857
2020-08-03,19900,1646,43,21589,13894.42857142857
2020-08-04,15992,1432,31,17455,13696.42857142857
2020-08-05,13025,1356,18,14399,13596.714285714286
2020-08-06,12327,1142,13,13482,13555.857142857143
2020-08-07,13211,1114,19,14344,13590
2020-08-08,6685,706,7,7398,13523.285714285714
2020-08-09,5181,474,8,5663,13475.714285714286
2020-08-10,16991,1432,21,18444,13026.42857142857
2020-08-11,14171,1270,27,15468,12742.57142857143
2020-08-12,12131,1377,35,13543,12620.285714285714
2020-08-13,12812,1120,17,13949,12687
2020-08-14,13432,1111,16,14559,12717.714285714286
2020-08-15,5945,638,13,6596,12603.142857142857
2020-08-16,4866,530,14,5410,12567
2020-08-17,12711,1506,18,14235,11965.714285714286
2020-08-18,13161,1191,21,14373,11809.285714285714
2020-08-19,11269,1259,19,12547,11667
2020-08-20,10137,1218,21,11376,11299.42857142857
2020-08-21,10208,1100,13,11321,10836.857142857143
2020-08-22,4925,582,7,5514,10682.285714285714
2020-08-23,3657,525,16,4198,10509.142857142857
2020-08-24,13209,1532,18,14759,10584
2020-08-25,12909,1319,21,14249,10566.285714285714
2020-08-26,10495,1370,22,11887,10472
2020-08-27,8658,1110,11,9779,10243.857142857143
2020-08-28,6389,729,8,7126,9644.57142857143
