report_date,pcr_neg,pcr_pos,pcr_int,pcr_total,pcr_avg
2020-03-16,409,30,0,439,NA
2020-03-17,635,50,0,685,NA
2020-03-18,737,57,2,796,NA
2020-03-19,1057,71,1,1129,NA
2020-03-20,1076,104,2,1182,NA
2020-03-21,741,82,2,825,NA
2020-03-22,626,80,0,706,823.1428571428571
2020-03-23,1629,176,4,1809,1018.8571428571429
2020-03-24,1850,214,0,2064,1215.857142857143
2020-03-25,2221,224,6,2451,1452.2857142857142
2020-03-26,2173,258,1,2432,1638.4285714285713
2020-03-27,1883,296,0,2179,1780.857142857143
2020-03-28,1092,193,2,1287,1846.857142857143
2020-03-29,751,139,0,890,1873.142857142857
2020-03-30,2426,361,0,2787,2012.857142857143
2020-03-31,2199,301,1,2501,2075.285714285714
2020-04-01,2045,274,2,2321,2056.714285714286
2020-04-02,1888,292,3,2183,2021.142857142857
2020-04-03,1732,251,2,1985,1993.4285714285713
2020-04-04,950,145,2,1097,1966.2857142857142
2020-04-05,784,113,3,900,1967.7142857142858
2020-04-06,2417,319,7,2743,1961.4285714285713
2020-04-07,2081,242,2,2325,1936.2857142857142
2020-04-08,2060,252,1,2313,1935.142857142857
2020-04-09,1766,215,4,1985,1906.857142857143
2020-04-10,1986,241,5,2232,1942.142857142857
2020-04-11,851,105,1,957,1922.142857142857
2020-04-12,694,101,3,798,1907.5714285714287
2020-04-13,1977,287,4,2268,1839.7142857142858
2020-04-14,1959,235,6,2200,1821.857142857143
2020-04-15,1831,241,4,2076,1788
2020-04-16,1840,234,4,2078,1801.2857142857142
2020-04-17,2171,202,4,2377,1822
2020-04-18,1080,174,0,1254,1864.4285714285713
2020-04-19,830,150,2,982,1890.7142857142858
2020-04-20,2443,315,10,2768,1962.142857142857
2020-04-21,2297,273,9,2579,2016.2857142857142
2020-04-22,2704,279,6,2989,2146.714285714286
2020-04-23,2640,282,9,2931,2268.5714285714284
2020-04-24,2470,263,17,2750,2321.8571428571427
2020-04-25,1172,139,1,1312,2330.1428571428573
2020-04-26,1042,90,1,1133,2351.714285714286
2020-04-27,3787,349,7,4143,2548.1428571428573
2020-04-28,4566,430,14,5010,2895.4285714285716
2020-04-29,4569,379,9,4957,3176.5714285714284
2020-04-30,3846,334,11,4191,3356.5714285714284
2020-05-01,4225,340,13,4578,3617.714285714286
2020-05-02,1581,92,2,1675,3669.5714285714284
2020-05-03,1097,90,2,1189,3677.5714285714284
2020-05-04,3859,304,14,4177,3682.4285714285716
2020-05-05,4620,325,17,4962,3675.5714285714284
2020-05-06,4078,260,8,4346,3588.285714285714
2020-05-07,3769,181,10,3960,3555.285714285714
2020-05-08,4391,178,6,4575,3554.8571428571427
2020-05-09,2099,133,4,2236,3635
2020-05-10,1253,76,0,1329,3655
2020-05-11,5060,261,11,5332,3820
2020-05-12,5270,234,7,5511,3898.4285714285716
2020-05-13,5346,339,9,5694,4091
2020-05-14,4866,266,3,5135,4258.857142857143
2020-05-15,5686,255,13,5954,4455.857142857143
2020-05-16,3882,99,2,3983,4705.428571428572
2020-05-17,2765,125,3,2893,4928.857142857143
2020-05-18,6445,283,6,6734,5129.142857142857
2020-05-19,5784,298,6,6088,5211.571428571428
2020-05-20,5748,307,3,6058,5263.571428571428
2020-05-21,5586,320,10,5916,5375.142857142857
2020-05-22,6899,251,9,7159,5547.285714285715
2020-05-23,2987,109,2,3098,5420.857142857143
2020-05-24,2458,82,3,2543,5370.857142857143
2020-05-25,2348,94,2,2444,4758
2020-05-26,12657,362,13,13032,5750
2020-05-27,11515,357,10,11882,6582
2020-05-28,10210,271,7,10488,7235.142857142857
2020-05-29,9487,271,7,9765,7607.428571428572
2020-05-30,4330,327,4,4661,7830.714285714285
2020-05-31,2767,215,3,2985,7893.857142857143
2020-06-01,10085,354,81,10520,9047.57142857143
2020-06-02,8405,283,13,8701,8428.857142857143
2020-06-03,8777,281,10,9068,8026.857142857143
2020-06-04,7640,309,18,7967,7666.714285714285
2020-06-05,8701,322,9,9032,7562
2020-06-06,3315,125,3,3443,7388
2020-06-07,2322,81,0,2403,7304.857142857143
2020-06-08,9499,368,8,9875,7212.714285714285
2020-06-09,10173,386,2,10561,7478.428571428572
2020-06-10,9897,378,10,10285,7652.285714285715
2020-06-11,7936,457,7,8400,7714.142857142857
2020-06-12,8455,389,10,8854,7688.714285714285
2020-06-13,3820,171,6,3997,7767.857142857143
2020-06-14,2601,124,1,2726,7814
2020-06-15,13854,520,43,14417,8462.857142857143
2020-06-16,11656,577,112,12345,8717.714285714286
2020-06-17,9770,513,19,10302,8720.142857142857
2020-06-18,9500,666,41,10207,8978.285714285714
2020-06-19,10500,492,18,11010,9286.285714285714
2020-06-20,4480,258,11,4749,9393.714285714286
2020-06-21,2878,234,0,3112,9448.857142857143
2020-06-22,15404,720,92,16216,9705.857142857143
2020-06-23,11699,668,27,12394,9712.857142857143
2020-06-24,11017,746,29,11792,9925.714285714286
2020-06-25,9448,653,17,10118,9913
2020-06-26,11777,667,10,12454,10119.285714285714
2020-06-27,5570,428,3,6001,10298.142857142857
2020-06-28,4620,291,2,4913,10555.42857142857
2020-06-29,17542,996,33,18571,10891.857142857143
2020-06-30,14257,1010,16,15283,11304.57142857143
2020-07-01,13510,1069,25,14604,11706.285714285714
2020-07-02,12601,1103,14,13718,12220.57142857143
2020-07-03,8025,730,14,8769,11694.142857142857
2020-07-04,3630,358,6,3994,11407.42857142857
2020-07-05,4042,380,0,4422,11337.285714285714
2020-07-06,16215,1295,13,17523,11187.57142857143
2020-07-07,15914,1376,18,17308,11476.857142857143
2020-07-08,15619,1477,22,17118,11836
2020-07-09,15392,1350,40,16782,12273.714285714286
2020-07-10,14957,1293,33,16283,13347.142857142857
2020-07-11,8862,715,28,9605,14148.714285714286
2020-07-12,5811,498,7,6316,14419.285714285714
2020-07-13,20875,1543,54,22472,15126.285714285714
2020-07-14,18300,1490,34,19824,15485.714285714286
2020-07-15,16588,1327,22,17937,15602.714285714286
2020-07-16,13718,1226,15,14959,15342.285714285714
2020-07-17,14961,1187,15,16163,15325.142857142857
2020-07-18,7554,764,15,8333,15143.42857142857
2020-07-19,5020,555,12,5587,15039.285714285714
2020-07-20,20351,1703,31,22085,14984
2020-07-21,16814,1459,35,18308,14767.42857142857
2020-07-22,13810,1420,22,15252,14383.857142857143
2020-07-23,14391,1409,36,15836,14509.142857142857
2020-07-24,14766,1320,28,16114,14502.142857142857
2020-07-25,7660,655,10,8325,14501
2020-07-26,5413,490,15,5918,14548.285714285714
2020-07-27,18785,1556,40,20381,14304.857142857143
2020-07-28,17780,1360,29,19169,14427.857142857143
2020-07-29,13910,1440,29,15379,14446
2020-07-30,12749,1250,19,14018,14186.285714285714
2020-07-31,13253,1130,10,14393,13940.42857142857
2020-08-01,7255,612,20,7887,13877.857142857143
2020-08-02,5379,617,22,6018,13892.142857142857
2020-08-03,20145,1673,44,21862,14103.714285714286
2020-08-04,16225,1446,29,17700,13893.857142857143
2020-08-05,13425,1367,22,14814,13813.142857142857
2020-08-06,12548,1155,10,13713,13769.57142857143
2020-08-07,13685,1098,23,14806,13828.57142857143
2020-08-08,6692,700,8,7400,13759
2020-08-09,5175,470,9,5654,13707
2020-08-10,17279,1448,24,18751,13262.57142857143
2020-08-11,14545,1262,25,15832,12995.714285714286
2020-08-12,12272,1369,34,13675,12833
2020-08-13,13083,1112,17,14212,12904.285714285714
2020-08-14,13558,1118,12,14688,12887.42857142857
2020-08-15,5927,623,13,6563,12767.857142857143
2020-08-16,4837,528,15,5380,12728.714285714286
2020-08-17,13471,1500,20,14991,12191.57142857143
2020-08-18,13945,1196,23,15164,12096.142857142857
2020-08-19,12046,1242,22,13310,12044
2020-08-20,10321,1216,23,11560,11665.142857142857
2020-08-21,10402,1083,12,11497,11209.285714285714
2020-08-22,4929,555,6,5490,11056
2020-08-23,3577,514,18,4109,10874.42857142857
2020-08-24,13555,1527,26,15108,10891.142857142857
2020-08-25,13643,1351,24,15018,10870.285714285714
2020-08-26,12199,1471,21,13691,10924.714285714286
2020-08-27,11473,1283,13,12769,11097.42857142857
2020-08-28,11185,1285,20,12490,11239.285714285714
2020-08-29,4516,709,8,5233,11202.57142857143
2020-08-30,3456,571,10,4037,11192.285714285714
2020-08-31,12256,1641,34,13931,11024.142857142857
2020-09-01,10339,1371,25,11735,10555.142857142857
2020-09-02,10530,1435,34,11999,10313.42857142857
2020-09-03,8450,1111,73,9634,9865.57142857143
2020-09-04,5692,803,5,6500,9009.857142857143
