report_date,pcr_neg,pcr_pos,pcr_int,pcr_total,pcr_avg
2020-03-16,409,30,0,439,NA
2020-03-17,635,50,0,685,NA
2020-03-18,737,57,2,796,NA
2020-03-19,1056,71,1,1128,NA
2020-03-20,1076,104,2,1182,NA
2020-03-21,741,82,2,825,NA
2020-03-22,626,80,0,706,823
2020-03-23,1628,176,4,1808,1018.5714285714286
2020-03-24,1850,214,0,2064,1215.5714285714287
2020-03-25,2205,224,6,2435,1449.7142857142858
2020-03-26,2166,258,1,2425,1635
2020-03-27,1841,296,0,2137,1771.4285714285713
2020-03-28,1090,194,2,1286,1837.2857142857142
2020-03-29,747,139,0,886,1863
2020-03-30,2407,361,0,2768,2000.142857142857
2020-03-31,2167,301,1,2469,2058
2020-04-01,2020,274,2,2296,2038.142857142857
2020-04-02,1886,292,3,2181,2003.2857142857142
2020-04-03,1731,251,2,1984,1981.4285714285713
2020-04-04,950,145,2,1097,1954.4285714285713
2020-04-05,784,113,3,900,1956.4285714285713
2020-04-06,2417,319,7,2743,1952.857142857143
2020-04-07,2081,242,2,2325,1932.2857142857142
2020-04-08,2060,252,1,2313,1934.7142857142858
2020-04-09,1766,215,4,1985,1906.7142857142858
2020-04-10,1986,241,5,2232,1942.142857142857
2020-04-11,851,105,1,957,1922.142857142857
2020-04-12,694,101,3,798,1907.5714285714287
2020-04-13,1977,287,4,2268,1839.7142857142858
2020-04-14,1959,235,6,2200,1821.857142857143
2020-04-15,1831,241,4,2076,1788
2020-04-16,1840,234,4,2078,1801.2857142857142
2020-04-17,2171,202,4,2377,1822
2020-04-18,1080,174,0,1254,1864.4285714285713
2020-04-19,830,150,2,982,1890.7142857142858
2020-04-20,2443,315,10,2768,1962.142857142857
2020-04-21,2297,274,9,2580,2016.4285714285713
2020-04-22,2704,279,6,2989,2146.8571428571427
2020-04-23,2639,281,9,2929,2268.4285714285716
2020-04-24,2470,263,17,2750,2321.714285714286
2020-04-25,1172,139,1,1312,2330
2020-04-26,1042,90,1,1133,2351.5714285714284
2020-04-27,3780,349,7,4136,2547
2020-04-28,4564,429,14,5007,2893.714285714286
2020-04-29,4556,379,9,4944,3173
2020-04-30,3839,334,11,4184,3352.285714285714
2020-05-01,4216,338,13,4567,3611.8571428571427
2020-05-02,1577,92,2,1671,3663.1428571428573
2020-05-03,1089,89,2,1180,3669.8571428571427
2020-05-04,3856,304,14,4174,3675.285714285714
2020-05-05,4618,326,17,4961,3668.714285714286
2020-05-06,4075,260,8,4343,3582.8571428571427
2020-05-07,3769,181,10,3960,3550.8571428571427
2020-05-08,4390,178,6,4574,3551.8571428571427
2020-05-09,2099,133,4,2236,3632.5714285714284
2020-05-10,1253,76,0,1329,3653.8571428571427
2020-05-11,5055,261,11,5327,3818.5714285714284
2020-05-12,5257,234,7,5498,3895.285714285714
2020-05-13,5340,339,9,5688,4087.4285714285716
2020-05-14,4860,266,3,5129,4254.428571428572
2020-05-15,5682,255,13,5950,4451
2020-05-16,3882,99,2,3983,4700.571428571428
2020-05-17,2765,125,3,2893,4924
2020-05-18,6444,283,6,6733,5124.857142857143
2020-05-19,5782,298,6,6086,5208.857142857143
2020-05-20,5745,307,3,6055,5261.285714285715
2020-05-21,5583,320,10,5913,5373.285714285715
2020-05-22,6893,251,9,7153,5545.142857142857
2020-05-23,2987,109,2,3098,5418.714285714285
2020-05-24,2458,82,3,2543,5368.714285714285
2020-05-25,2348,94,2,2444,4756
2020-05-26,12654,362,13,13029,5747.857142857143
2020-05-27,11512,357,10,11879,6579.857142857143
2020-05-28,10207,271,7,10485,7233
2020-05-29,9477,271,7,9755,7604.714285714285
2020-05-30,4329,327,4,4660,7827.857142857143
2020-05-31,2767,215,3,2985,7891
2020-06-01,10085,354,81,10520,9044.714285714286
2020-06-02,8398,283,13,8694,8425.42857142857
2020-06-03,8773,281,10,9064,8023.285714285715
2020-06-04,7639,309,18,7966,7663.428571428572
2020-06-05,8692,322,9,9023,7558.857142857143
2020-06-06,3315,125,3,3443,7385
2020-06-07,2322,81,0,2403,7301.857142857143
2020-06-08,9492,368,8,9868,7208.714285714285
2020-06-09,10173,386,2,10561,7475.428571428572
2020-06-10,9896,378,10,10284,7649.714285714285
2020-06-11,7935,445,7,8387,7709.857142857143
2020-06-12,8451,389,10,8850,7685.142857142857
2020-06-13,3820,171,6,3997,7764.285714285715
2020-06-14,2601,124,1,2726,7810.428571428572
2020-06-15,13848,520,43,14411,8459.42857142857
2020-06-16,11654,577,112,12343,8714
2020-06-17,9770,513,19,10302,8716.57142857143
2020-06-18,9495,666,41,10202,8975.857142857143
2020-06-19,10493,492,18,11003,9283.42857142857
2020-06-20,4480,258,11,4749,9390.857142857143
2020-06-21,2877,234,0,3111,9445.857142857143
2020-06-22,15401,720,92,16213,9703.285714285714
2020-06-23,11692,668,26,12386,9709.42857142857
2020-06-24,11014,746,29,11789,9921.857142857143
2020-06-25,9445,653,17,10115,9909.42857142857
2020-06-26,11772,668,10,12450,10116.142857142857
2020-06-27,5562,428,3,5993,10293.857142857143
2020-06-28,4619,289,2,4910,10550.857142857143
2020-06-29,17536,997,33,18566,10887
2020-06-30,14245,1011,16,15272,11299.285714285714
2020-07-01,13503,1070,25,14598,11700.57142857143
2020-07-02,12586,1105,14,13705,12213.42857142857
2020-07-03,8005,723,14,8742,11683.714285714286
2020-07-04,3627,357,6,3990,11397.57142857143
2020-07-05,4039,379,0,4418,11327.285714285714
2020-07-06,16031,1298,13,17342,11152.42857142857
2020-07-07,15816,1362,19,17197,11427.42857142857
2020-07-08,15365,1464,21,16850,11749.142857142857
2020-07-09,15259,1345,40,16644,12169
2020-07-10,14911,1291,34,16236,13239.57142857143
2020-07-11,8708,715,28,9451,14019.714285714286
2020-07-12,5791,497,7,6295,14287.857142857143
2020-07-13,20708,1541,54,22303,14996.57142857143
2020-07-14,18072,1467,34,19573,15336
2020-07-15,16334,1287,22,17643,15449.285714285714
2020-07-16,13630,1225,15,14870,15195.857142857143
2020-07-17,14645,1189,14,15848,15140.42857142857
2020-07-18,7542,766,14,8322,14979.142857142857
2020-07-19,5013,554,12,5579,14876.857142857143
2020-07-20,20204,1702,32,21938,14824.714285714286
2020-07-21,16718,1453,34,18205,14629.285714285714
2020-07-22,13649,1414,22,15085,14263.857142857143
2020-07-23,14275,1408,35,15718,14385
2020-07-24,14542,1324,29,15895,14391.714285714286
2020-07-25,7645,653,10,8308,14389.714285714286
2020-07-26,5403,489,15,5907,14436.57142857143
2020-07-27,18628,1549,40,20217,14190.714285714286
2020-07-28,17589,1330,29,18948,14296.857142857143
2020-07-29,13775,1431,29,15235,14318.285714285714
2020-07-30,12541,1245,19,13805,14045
2020-07-31,13000,1119,10,14129,13792.714285714286
2020-08-01,7243,614,20,7877,13731.142857142857
2020-08-02,5358,617,22,5997,13744
2020-08-03,20018,1663,44,21725,13959.42857142857
2020-08-04,16081,1432,31,17544,13758.857142857143
2020-08-05,13235,1372,21,14628,13672.142857142857
2020-08-06,12415,1167,10,13592,13641.714285714286
2020-08-07,13329,1106,21,14456,13688.42857142857
2020-08-08,6692,693,8,7393,13619.285714285714
2020-08-09,5177,473,9,5659,13571
2020-08-10,17073,1423,23,18519,13113
2020-08-11,14434,1274,29,15737,12854.857142857143
2020-08-12,12198,1384,34,13616,12710.285714285714
2020-08-13,12874,1124,16,14014,12770.57142857143
2020-08-14,13446,1109,16,14571,12787
2020-08-15,5924,629,12,6565,12668.714285714286
2020-08-16,4855,549,16,5420,12634.57142857143
2020-08-17,12726,1507,23,14256,12025.57142857143
2020-08-18,13135,1215,20,14370,11830.285714285714
2020-08-19,11263,1245,20,12528,11674.857142857143
2020-08-20,10179,1238,25,11442,11307.42857142857
2020-08-21,10200,1103,12,11315,10842.285714285714
2020-08-22,4944,563,6,5513,10692
2020-08-23,3658,521,18,4197,10517.285714285714
2020-08-24,13517,1530,27,15074,10634.142857142857
2020-08-25,13490,1344,20,14854,10703.285714285714
2020-08-26,12195,1438,19,13652,10863.857142857143
2020-08-27,11001,1282,14,12297,10986
2020-08-28,10869,1268,19,12156,11106.142857142857
2020-08-29,4403,687,9,5099,11047
2020-08-30,2992,529,8,3529,10951.57142857143
2020-08-31,7277,1231,22,8530,10016.714285714286
