report_date,pcr_neg,pcr_pos,pcr_int,pcr_total,pcr_avg
2020-03-16,409,30,0,439,NA
2020-03-17,635,50,0,685,NA
2020-03-18,737,57,2,796,NA
2020-03-19,1056,71,1,1128,NA
2020-03-20,1076,104,2,1182,NA
2020-03-21,741,82,2,825,NA
2020-03-22,626,79,0,705,822.8571428571429
2020-03-23,1628,176,4,1808,1018.4285714285714
2020-03-24,1850,214,0,2064,1215.4285714285713
2020-03-25,2205,224,6,2435,1449.5714285714287
2020-03-26,2166,258,1,2425,1634.857142857143
2020-03-27,1841,296,0,2137,1771.2857142857142
2020-03-28,1090,193,2,1285,1837
2020-03-29,747,139,0,886,1862.857142857143
2020-03-30,2407,361,0,2768,2000
2020-03-31,2167,301,1,2469,2057.8571428571427
2020-04-01,2020,274,2,2296,2038
2020-04-02,1886,292,3,2181,2003.142857142857
2020-04-03,1731,251,2,1984,1981.2857142857142
2020-04-04,950,145,2,1097,1954.4285714285713
2020-04-05,784,113,3,900,1956.4285714285713
2020-04-06,2417,319,7,2743,1952.857142857143
2020-04-07,2081,242,2,2325,1932.2857142857142
2020-04-08,2060,252,1,2313,1934.7142857142858
2020-04-09,1766,214,4,1984,1906.5714285714287
2020-04-10,1986,241,5,2232,1942
2020-04-11,851,105,1,957,1922
2020-04-12,694,99,3,796,1907.142857142857
2020-04-13,1977,282,4,2263,1838.5714285714287
2020-04-14,1959,235,6,2200,1820.7142857142858
2020-04-15,1831,241,4,2076,1786.857142857143
2020-04-16,1840,234,4,2078,1800.2857142857142
2020-04-17,2171,202,4,2377,1821
2020-04-18,1080,173,0,1253,1863.2857142857142
2020-04-19,830,150,2,982,1889.857142857143
2020-04-20,2443,315,10,2768,1962
2020-04-21,2297,274,9,2580,2016.2857142857142
2020-04-22,2704,279,6,2989,2146.714285714286
2020-04-23,2639,281,9,2929,2268.285714285714
2020-04-24,2470,263,17,2750,2321.5714285714284
2020-04-25,1172,139,1,1312,2330
2020-04-26,1042,90,1,1133,2351.5714285714284
2020-04-27,3780,349,7,4136,2547
2020-04-28,4564,429,14,5007,2893.714285714286
2020-04-29,4555,379,9,4943,3172.8571428571427
2020-04-30,3839,335,11,4185,3352.285714285714
2020-05-01,4216,338,13,4567,3611.8571428571427
2020-05-02,1577,92,2,1671,3663.1428571428573
2020-05-03,1089,89,2,1180,3669.8571428571427
2020-05-04,3856,304,14,4174,3675.285714285714
2020-05-05,4618,326,17,4961,3668.714285714286
2020-05-06,4075,260,8,4343,3583
2020-05-07,3768,182,10,3960,3550.8571428571427
2020-05-08,4390,178,6,4574,3551.8571428571427
2020-05-09,2099,133,4,2236,3632.5714285714284
2020-05-10,1253,76,0,1329,3653.8571428571427
2020-05-11,5055,261,11,5327,3818.5714285714284
2020-05-12,5257,233,7,5497,3895.1428571428573
2020-05-13,5340,339,9,5688,4087.285714285714
2020-05-14,4860,266,3,5129,4254.285714285715
2020-05-15,5682,254,13,5949,4450.714285714285
2020-05-16,3882,99,2,3983,4700.285714285715
2020-05-17,2765,125,3,2893,4923.714285714285
2020-05-18,6444,283,6,6733,5124.571428571428
2020-05-19,5782,298,6,6086,5208.714285714285
2020-05-20,5745,307,3,6055,5261.142857142857
2020-05-21,5582,320,10,5912,5373
2020-05-22,6892,251,9,7152,5544.857142857143
2020-05-23,2987,109,2,3098,5418.428571428572
2020-05-24,2458,82,3,2543,5368.428571428572
2020-05-25,2348,94,2,2444,4755.714285714285
2020-05-26,12654,362,13,13029,5747.571428571428
2020-05-27,11512,357,10,11879,6579.571428571428
2020-05-28,10206,271,7,10484,7232.714285714285
2020-05-29,9476,271,7,9754,7604.428571428572
2020-05-30,4329,327,4,4660,7827.571428571428
2020-05-31,2767,215,3,2985,7890.714285714285
2020-06-01,10085,354,81,10520,9044.42857142857
2020-06-02,8397,283,13,8693,8425
2020-06-03,8772,281,10,9063,8022.714285714285
2020-06-04,7638,309,18,7965,7662.857142857143
2020-06-05,8692,322,9,9023,7558.428571428572
2020-06-06,3315,125,3,3443,7384.571428571428
2020-06-07,2322,81,0,2403,7301.428571428572
2020-06-08,9491,368,8,9867,7208.142857142857
2020-06-09,10173,386,2,10561,7475
2020-06-10,9895,378,10,10283,7649.285714285715
2020-06-11,7935,446,7,8388,7709.714285714285
2020-06-12,8451,389,10,8850,7685
2020-06-13,3820,171,6,3997,7764.142857142857
2020-06-14,2601,124,1,2726,7810.285714285715
2020-06-15,13848,520,43,14411,8459.42857142857
2020-06-16,11653,577,112,12342,8713.857142857143
2020-06-17,9770,512,19,10301,8716.42857142857
2020-06-18,9494,666,41,10201,8975.42857142857
2020-06-19,10493,492,18,11003,9283
2020-06-20,4480,258,11,4749,9390.42857142857
2020-06-21,2877,234,0,3111,9445.42857142857
2020-06-22,15400,720,92,16212,9702.714285714286
2020-06-23,11691,668,27,12386,9709
2020-06-24,11012,746,29,11787,9921.285714285714
2020-06-25,9445,654,17,10116,9909.142857142857
2020-06-26,11771,668,10,12449,10115.714285714286
2020-06-27,5562,428,3,5993,10293.42857142857
2020-06-28,4619,289,2,4910,10550.42857142857
2020-06-29,17535,997,33,18565,10886.57142857143
2020-06-30,14242,1009,16,15267,11298.142857142857
2020-07-01,13501,1070,25,14596,11699.42857142857
2020-07-02,12585,1105,14,13704,12212
2020-07-03,8005,722,14,8741,11682.285714285714
2020-07-04,3627,357,6,3990,11396.142857142857
2020-07-05,4039,379,0,4418,11325.857142857143
2020-07-06,16031,1298,13,17342,11151.142857142857
2020-07-07,15814,1361,19,17194,11426.42857142857
2020-07-08,15364,1464,21,16849,11748.285714285714
2020-07-09,15258,1344,40,16642,12168
2020-07-10,14911,1291,34,16236,13238.714285714286
2020-07-11,8708,715,28,9451,14018.857142857143
2020-07-12,5791,496,7,6294,14286.857142857143
2020-07-13,20707,1539,54,22300,14995.142857142857
2020-07-14,18073,1457,34,19564,15333.714285714286
2020-07-15,16333,1276,22,17631,15445.42857142857
2020-07-16,13627,1225,15,14867,15191.857142857143
2020-07-17,14640,1188,15,15843,15135.714285714286
2020-07-18,7545,764,14,8323,14974.57142857143
2020-07-19,5013,554,12,5579,14872.42857142857
2020-07-20,20200,1703,32,21935,14820.285714285714
2020-07-21,16711,1454,34,18199,14625.285714285714
2020-07-22,13647,1412,22,15081,14261
2020-07-23,14262,1405,35,15702,14380.285714285714
2020-07-24,14536,1330,29,15895,14387.714285714286
2020-07-25,7645,652,10,8307,14385.42857142857
2020-07-26,5403,492,15,5910,14432.714285714286
2020-07-27,18623,1549,40,20212,14186.57142857143
2020-07-28,17583,1337,30,18950,14293.857142857143
2020-07-29,13761,1423,29,15213,14312.714285714286
2020-07-30,12534,1243,19,13796,14040.42857142857
2020-07-31,12991,1123,10,14124,13787.42857142857
2020-08-01,7241,612,20,7873,13725.42857142857
2020-08-02,5365,618,22,6005,13739
2020-08-03,19997,1656,44,21697,13951.142857142857
2020-08-04,16035,1428,27,17490,13742.57142857143
2020-08-05,13182,1368,21,14571,13650.857142857143
2020-08-06,12364,1155,11,13530,13612.857142857143
2020-08-07,13305,1112,21,14438,13657.714285714286
2020-08-08,6679,686,9,7374,13586.42857142857
2020-08-09,5164,473,8,5645,13535
2020-08-10,17043,1447,21,18511,13079.857142857143
2020-08-11,14399,1278,29,15706,12825
2020-08-12,12161,1410,35,13606,12687.142857142857
2020-08-13,12845,1117,16,13978,12751.142857142857
2020-08-14,13449,1103,11,14563,12769
2020-08-15,5934,625,8,6567,12653.714285714286
2020-08-16,4867,525,16,5408,12619.857142857143
2020-08-17,12704,1504,27,14235,12009
2020-08-18,13180,1218,21,14419,11825.142857142857
2020-08-19,11279,1275,22,12576,11678
2020-08-20,10166,1227,20,11413,11311.57142857143
2020-08-21,10226,1094,14,11334,10850.285714285714
2020-08-22,4939,577,9,5525,10701.42857142857
2020-08-23,3656,522,18,4196,10528.285714285714
2020-08-24,13532,1526,23,15081,10649.142857142857
2020-08-25,13442,1332,24,14798,10703.285714285714
2020-08-26,11805,1437,24,13266,10801.857142857143
2020-08-27,10509,1242,13,11764,10852
2020-08-28,9645,1219,19,10883,10787.57142857143
2020-08-29,4122,594,7,4723,10673
2020-08-30,2479,384,1,2864,10482.714285714286
