report_date,pcr_neg,pcr_pos,pcr_int,pcr_total,pcr_avg
2020-03-16,409,30,0,439,NA
2020-03-17,635,50,0,685,NA
2020-03-18,738,57,2,797,NA
2020-03-19,1057,71,1,1129,NA
2020-03-20,1076,103,2,1181,NA
2020-03-21,741,82,2,825,NA
2020-03-22,626,79,0,705,823
2020-03-23,1630,176,4,1810,1018.8571428571429
2020-03-24,1850,214,0,2064,1215.857142857143
2020-03-25,2221,224,6,2451,1452.142857142857
2020-03-26,2172,258,1,2431,1638.142857142857
2020-03-27,1883,296,0,2179,1780.7142857142858
2020-03-28,1092,194,2,1288,1846.857142857143
2020-03-29,751,139,0,890,1873.2857142857142
2020-03-30,2426,361,0,2787,2012.857142857143
2020-03-31,2198,301,1,2500,2075.1428571428573
2020-04-01,2046,273,2,2321,2056.5714285714284
2020-04-02,1888,292,3,2183,2021.142857142857
2020-04-03,1733,250,2,1985,1993.4285714285713
2020-04-04,952,146,2,1100,1966.5714285714287
2020-04-05,784,113,3,900,1968
2020-04-06,2417,320,7,2744,1961.857142857143
2020-04-07,2081,242,2,2325,1936.857142857143
2020-04-08,2060,252,1,2313,1935.7142857142858
2020-04-09,1766,218,4,1988,1907.857142857143
2020-04-10,1986,241,5,2232,1943.142857142857
2020-04-11,851,107,1,959,1923
2020-04-12,694,101,3,798,1908.4285714285713
2020-04-13,1978,287,4,2269,1840.5714285714287
2020-04-14,1967,235,6,2208,1823.857142857143
2020-04-15,1844,242,4,2090,1792
2020-04-16,1845,235,4,2084,1805.7142857142858
2020-04-17,2177,203,4,2384,1827.4285714285713
2020-04-18,1085,173,0,1258,1870.142857142857
2020-04-19,831,151,2,984,1896.7142857142858
2020-04-20,2460,317,10,2787,1970.7142857142858
2020-04-21,2303,275,9,2587,2024.857142857143
2020-04-22,2708,279,6,2993,2153.8571428571427
2020-04-23,2657,281,9,2947,2277.1428571428573
2020-04-24,2480,263,17,2760,2330.8571428571427
2020-04-25,1179,139,1,1319,2339.5714285714284
2020-04-26,1050,90,1,1141,2362
2020-04-27,3790,350,7,4147,2556.285714285714
2020-04-28,4574,431,14,5019,2903.714285714286
2020-04-29,4620,380,9,5009,3191.714285714286
2020-04-30,3870,337,11,4218,3373.285714285714
2020-05-01,4244,339,13,4596,3635.5714285714284
2020-05-02,1590,91,2,1683,3687.5714285714284
2020-05-03,1105,90,2,1197,3695.5714285714284
2020-05-04,3872,304,14,4190,3701.714285714286
2020-05-05,4635,325,17,4977,3695.714285714286
2020-05-06,4090,260,8,4358,3602.714285714286
2020-05-07,3786,181,10,3977,3568.285714285714
2020-05-08,4408,178,6,4592,3567.714285714286
2020-05-09,2147,133,4,2284,3653.5714285714284
2020-05-10,1267,76,0,1343,3674.4285714285716
2020-05-11,5081,262,11,5354,3840.714285714286
2020-05-12,5281,233,7,5521,3918.4285714285716
2020-05-13,5373,343,9,5725,4113.714285714285
2020-05-14,4880,265,4,5149,4281.142857142857
2020-05-15,5707,254,14,5975,4478.714285714285
2020-05-16,3889,100,2,3991,4722.571428571428
2020-05-17,2773,125,3,2901,4945.142857142857
2020-05-18,6481,282,6,6769,5147.285714285715
2020-05-19,5826,299,6,6131,5234.428571428572
2020-05-20,5841,307,4,6152,5295.428571428572
2020-05-21,5622,320,10,5952,5410.142857142857
2020-05-22,6931,252,9,7192,5584
2020-05-23,2996,109,2,3107,5457.714285714285
2020-05-24,2463,82,3,2548,5407.285714285715
2020-05-25,2362,94,2,2458,4791.428571428572
2020-05-26,12719,363,13,13095,5786.285714285715
2020-05-27,11592,357,9,11958,6615.714285714285
2020-05-28,10308,271,7,10586,7277.714285714285
2020-05-29,9521,272,7,9800,7650.285714285715
2020-05-30,4342,322,4,4668,7873.285714285715
2020-05-31,2778,214,3,2995,7937.142857142857
2020-06-01,10169,354,81,10604,9100.857142857143
2020-06-02,8528,285,13,8826,8491
2020-06-03,8817,283,10,9110,8084.142857142857
2020-06-04,7714,310,18,8042,7720.714285714285
2020-06-05,8725,321,9,9055,7614.285714285715
2020-06-06,3373,125,3,3501,7447.571428571428
2020-06-07,2339,81,0,2420,7365.428571428572
2020-06-08,9588,369,9,9966,7274.285714285715
2020-06-09,10191,386,2,10579,7524.714285714285
2020-06-10,9997,378,10,10385,7706.857142857143
2020-06-11,7981,620,8,8609,7787.857142857143
2020-06-12,8494,390,11,8895,7765
2020-06-13,3836,171,6,4013,7838.142857142857
2020-06-14,2607,124,1,2732,7882.714285714285
2020-06-15,13932,519,44,14495,8529.714285714286
2020-06-16,11690,576,111,12377,8786.57142857143
2020-06-17,9847,512,19,10378,8785.57142857143
2020-06-18,9555,664,41,10260,9021.42857142857
2020-06-19,10549,493,17,11059,9330.57142857143
2020-06-20,4491,258,11,4760,9437.285714285714
2020-06-21,2899,233,0,3132,9494.42857142857
2020-06-22,15729,724,92,16545,9787.285714285714
2020-06-23,11993,672,26,12691,9832.142857142857
2020-06-24,11317,741,29,12087,10076.285714285714
2020-06-25,9751,658,16,10425,10099.857142857143
2020-06-26,12030,667,9,12706,10335.142857142857
2020-06-27,5667,425,3,6095,10525.857142857143
2020-06-28,4652,293,2,4947,10785.142857142857
2020-06-29,17977,1001,33,19011,11137.42857142857
2020-06-30,14621,1011,16,15648,11559.857142857143
2020-07-01,13921,1080,25,15026,11979.714285714286
2020-07-02,13098,1111,14,14223,12522.285714285714
2020-07-03,8377,735,15,9127,12011
2020-07-04,3711,358,6,4075,11722.42857142857
2020-07-05,4077,380,0,4457,11652.42857142857
2020-07-06,16810,1308,12,18130,11526.57142857143
2020-07-07,16483,1385,19,17887,11846.42857142857
2020-07-08,16068,1482,22,17572,12210.142857142857
2020-07-09,15575,1355,40,16970,12602.57142857143
2020-07-10,15092,1302,36,16430,13645.857142857143
2020-07-11,8907,723,29,9659,14443.57142857143
2020-07-12,5837,498,7,6342,14712.857142857143
2020-07-13,20926,1543,57,22526,15340.857142857143
2020-07-14,18361,1494,34,19889,15626.857142857143
2020-07-15,16674,1321,22,18017,15690.42857142857
2020-07-16,13914,1233,14,15161,15432
2020-07-17,15031,1191,14,16236,15404.285714285714
2020-07-18,7571,768,15,8354,15217.857142857143
2020-07-19,5035,563,12,5610,15113.285714285714
2020-07-20,20388,1704,31,22123,15055.714285714286
2020-07-21,16858,1463,35,18356,14836.714285714286
2020-07-22,13837,1420,22,15279,14445.57142857143
2020-07-23,14420,1412,37,15869,14546.714285714286
2020-07-24,14780,1318,29,16127,14531.142857142857
2020-07-25,7678,654,10,8342,14529.42857142857
2020-07-26,5436,492,15,5943,14577
2020-07-27,18819,1552,40,20411,14332.42857142857
2020-07-28,17821,1363,30,19214,14455
2020-07-29,13948,1441,28,15417,14474.714285714286
2020-07-30,12793,1251,20,14064,14216.857142857143
2020-07-31,13315,1132,10,14457,13978.285714285714
2020-08-01,7274,612,20,7906,13916
2020-08-02,5396,619,22,6037,13929.42857142857
2020-08-03,20152,1675,45,21872,14138.142857142857
2020-08-04,16269,1441,26,17736,13927
2020-08-05,13429,1371,18,14818,13841.42857142857
2020-08-06,12657,1153,11,13821,13806.714285714286
2020-08-07,13669,1119,21,14809,13857
2020-08-08,6737,701,7,7445,13791.142857142857
2020-08-09,5202,478,7,5687,13741.142857142857
2020-08-10,17251,1421,22,18694,13287.142857142857
2020-08-11,15039,1288,26,16353,13089.57142857143
2020-08-12,13376,1368,28,14772,13083
2020-08-13,13027,1132,17,14176,13133.714285714286
2020-08-14,13452,1120,16,14588,13102.142857142857
2020-08-15,6030,626,9,6665,12990.714285714286
2020-08-16,4842,532,12,5386,12947.714285714286
2020-08-17,13953,1479,23,15455,12485
2020-08-18,14231,1189,21,15441,12354.714285714286
2020-08-19,12445,1229,17,13691,12200.285714285714
2020-08-20,11579,1228,20,12827,12007.57142857143
2020-08-21,11838,1086,8,12932,11771
2020-08-22,5481,554,8,6043,11682.142857142857
2020-08-23,3551,498,15,4064,11493.285714285714
2020-08-24,13846,1502,28,15376,11482
2020-08-25,13943,1316,21,15280,11459
2020-08-26,12324,1460,28,13812,11476.285714285714
2020-08-27,12016,1270,15,13301,11544
2020-08-28,11747,1268,26,13041,11559.57142857143
2020-08-29,5557,685,11,6253,11589.57142857143
2020-08-30,3970,553,7,4530,11656.142857142857
2020-08-31,13554,1626,34,15214,11633
2020-09-01,13473,1423,20,14916,11581
2020-09-02,13839,1469,46,15354,11801.285714285714
2020-09-03,14286,1317,71,15674,12140.285714285714
2020-09-04,14155,1315,11,15481,12488.857142857143
2020-09-05,6532,730,9,7271,12634.285714285714
2020-09-06,4946,592,32,5570,12782.857142857143
2020-09-07,5940,662,3,6605,11553
2020-09-08,19569,1966,37,21572,12503.857142857143
2020-09-09,14650,1830,29,16509,12668.857142857143
2020-09-10,14141,1493,18,15652,12665.714285714286
2020-09-11,14862,1405,22,16289,12781.142857142857
2020-09-12,6827,729,8,7564,12823
2020-09-13,4949,571,6,5526,12816.714285714286
2020-09-14,18162,1588,34,19784,14699.42857142857
2020-09-15,11340,958,18,12316,13377.142857142857
