report_date,pcr_neg,pcr_pos,pcr_int,pcr_total,pcr_avg
2020-03-16,409,30,0,439,NA
2020-03-17,635,50,0,685,NA
2020-03-18,738,57,2,797,NA
2020-03-19,1057,71,1,1129,NA
2020-03-20,1076,104,2,1182,NA
2020-03-21,741,82,2,825,NA
2020-03-22,626,80,0,706,823.2857142857143
2020-03-23,1630,176,4,1810,1019.1428571428571
2020-03-24,1850,214,0,2064,1216.142857142857
2020-03-25,2221,224,6,2451,1452.4285714285713
2020-03-26,2174,258,1,2433,1638.7142857142858
2020-03-27,1883,296,0,2179,1781.142857142857
2020-03-28,1092,194,2,1288,1847.2857142857142
2020-03-29,752,139,0,891,1873.7142857142858
2020-03-30,2426,361,0,2787,2013.2857142857142
2020-03-31,2199,301,1,2501,2075.714285714286
2020-04-01,2046,274,2,2322,2057.285714285714
2020-04-02,1888,292,3,2183,2021.5714285714287
2020-04-03,1733,251,2,1986,1994
2020-04-04,952,146,2,1100,1967.142857142857
2020-04-05,784,113,3,900,1968.4285714285713
2020-04-06,2417,319,7,2743,1962.142857142857
2020-04-07,2082,242,2,2326,1937.142857142857
2020-04-08,2060,252,1,2313,1935.857142857143
2020-04-09,1766,216,4,1986,1907.7142857142858
2020-04-10,1986,241,5,2232,1942.857142857143
2020-04-11,851,105,1,957,1922.4285714285713
2020-04-12,694,101,3,798,1907.857142857143
2020-04-13,1982,287,4,2273,1840.7142857142858
2020-04-14,1959,235,6,2200,1822.7142857142858
2020-04-15,1831,241,4,2076,1788.857142857143
2020-04-16,1845,234,4,2083,1802.7142857142858
2020-04-17,2174,202,4,2380,1823.857142857143
2020-04-18,1081,174,0,1255,1866.4285714285713
2020-04-19,830,150,2,982,1892.7142857142858
2020-04-20,2444,316,10,2770,1963.7142857142858
2020-04-21,2298,274,9,2581,2018.142857142857
2020-04-22,2705,279,6,2990,2148.714285714286
2020-04-23,2641,281,9,2931,2269.8571428571427
2020-04-24,2470,263,17,2750,2322.714285714286
2020-04-25,1172,139,1,1312,2330.8571428571427
2020-04-26,1042,90,1,1133,2352.4285714285716
2020-04-27,3788,349,7,4144,2548.714285714286
2020-04-28,4567,431,14,5012,2896
2020-04-29,4610,380,9,4999,3183
2020-04-30,3869,334,11,4214,3366.285714285714
2020-05-01,4249,340,13,4602,3630.8571428571427
2020-05-02,1583,92,2,1677,3683
2020-05-03,1097,90,2,1189,3691
2020-05-04,3862,304,14,4180,3696.1428571428573
2020-05-05,4622,325,17,4964,3689.285714285714
2020-05-06,4078,261,8,4347,3596.1428571428573
2020-05-07,3770,182,10,3962,3560.1428571428573
2020-05-08,4397,178,6,4581,3557.1428571428573
2020-05-09,2099,133,4,2236,3637
2020-05-10,1255,76,0,1331,3657.285714285714
2020-05-11,5065,261,11,5337,3822.5714285714284
2020-05-12,5270,233,7,5510,3900.5714285714284
2020-05-13,5353,339,9,5701,4094
2020-05-14,4867,266,3,5136,4261.714285714285
2020-05-15,5686,255,13,5954,4457.857142857143
2020-05-16,3882,100,2,3984,4707.571428571428
2020-05-17,2765,125,3,2893,4930.714285714285
2020-05-18,6462,283,6,6751,5132.714285714285
2020-05-19,5812,298,6,6116,5219.285714285715
2020-05-20,5825,308,3,6136,5281.428571428572
2020-05-21,5605,320,10,5935,5395.571428571428
2020-05-22,6914,251,9,7174,5569.857142857143
2020-05-23,2987,109,2,3098,5443.285714285715
2020-05-24,2458,82,3,2543,5393.285714285715
2020-05-25,2348,94,2,2444,4778
2020-05-26,12700,362,13,13075,5772.142857142857
2020-05-27,11577,358,10,11945,6602
2020-05-28,10265,271,7,10543,7260.285714285715
2020-05-29,9505,271,7,9783,7633
2020-05-30,4330,327,4,4661,7856.285714285715
2020-05-31,2768,215,3,2986,7919.571428571428
2020-06-01,10155,355,81,10591,9083.42857142857
2020-06-02,8518,284,13,8815,8474.857142857143
2020-06-03,8807,282,10,9099,8068.285714285715
2020-06-04,7701,309,18,8028,7709
2020-06-05,8711,322,9,9042,7603.142857142857
2020-06-06,3365,125,3,3493,7436.285714285715
2020-06-07,2333,81,0,2414,7354.571428571428
2020-06-08,9570,368,8,9946,7262.428571428572
2020-06-09,10178,386,2,10566,7512.571428571428
2020-06-10,9983,378,10,10371,7694.285714285715
2020-06-11,7964,485,8,8457,7755.571428571428
2020-06-12,8484,389,10,8883,7732.857142857143
2020-06-13,3820,171,6,3997,7804.857142857143
2020-06-14,2601,124,1,2726,7849.428571428572
2020-06-15,13916,521,43,14480,8497.142857142857
2020-06-16,11678,577,112,12367,8754.42857142857
2020-06-17,9829,514,19,10362,8753.142857142857
2020-06-18,9543,666,41,10250,9009.285714285714
2020-06-19,10545,492,18,11055,9319.57142857143
2020-06-20,4480,258,11,4749,9427
2020-06-21,2878,234,0,3112,9482.142857142857
2020-06-22,15412,720,92,16224,9731.285714285714
2020-06-23,11706,669,27,12402,9736.285714285714
2020-06-24,11017,747,29,11793,9940.714285714286
2020-06-25,9453,655,16,10124,9922.714285714286
2020-06-26,11781,669,10,12460,10123.42857142857
2020-06-27,5573,428,3,6004,10302.714285714286
2020-06-28,4626,291,2,4919,10560.857142857143
2020-06-29,17548,998,33,18579,10897.285714285714
2020-06-30,14259,1006,16,15281,11308.57142857143
2020-07-01,13511,1069,26,14606,11710.42857142857
2020-07-02,12611,1100,14,13725,12224.857142857143
2020-07-03,8032,732,14,8778,11698.857142857143
2020-07-04,3629,358,6,3993,11411.57142857143
2020-07-05,4046,380,0,4426,11341.142857142857
2020-07-06,16232,1300,13,17545,11193.42857142857
2020-07-07,15925,1375,18,17318,11484.42857142857
2020-07-08,15617,1481,22,17120,11843.57142857143
2020-07-09,15397,1351,40,16788,12281.142857142857
2020-07-10,14962,1294,36,16292,13354.57142857143
2020-07-11,8875,718,27,9620,14158.42857142857
2020-07-12,5817,499,7,6323,14429.42857142857
2020-07-13,20888,1548,56,22492,15136.142857142857
2020-07-14,18300,1495,34,19829,15494.857142857143
2020-07-15,16595,1316,22,17933,15611
2020-07-16,13727,1231,15,14973,15351.714285714286
2020-07-17,14979,1191,14,16184,15336.285714285714
2020-07-18,7558,767,15,8340,15153.42857142857
2020-07-19,5031,559,12,5602,15050.42857142857
2020-07-20,20369,1706,32,22107,14995.42857142857
2020-07-21,16828,1459,35,18322,14780.142857142857
2020-07-22,13821,1423,22,15266,14399.142857142857
2020-07-23,14401,1416,36,15853,14524.857142857143
2020-07-24,14755,1320,29,16104,14513.42857142857
2020-07-25,7669,652,10,8331,14512.142857142857
2020-07-26,5423,493,15,5931,14559.142857142857
2020-07-27,18809,1556,40,20405,14316
2020-07-28,17801,1356,30,19187,14439.57142857143
2020-07-29,13940,1440,28,15408,14459.857142857143
2020-07-30,12780,1253,19,14052,14202.57142857143
2020-07-31,13279,1126,10,14415,13961.285714285714
2020-08-01,7262,612,20,7894,13898.857142857143
2020-08-02,5389,622,22,6033,13913.42857142857
2020-08-03,20137,1670,44,21851,14120
2020-08-04,16248,1448,32,17728,13911.57142857143
2020-08-05,13461,1377,19,14857,13832.857142857143
2020-08-06,12683,1153,10,13846,13803.42857142857
2020-08-07,13741,1114,19,14874,13869
2020-08-08,6746,708,9,7463,13807.42857142857
2020-08-09,5217,475,8,5700,13759.857142857143
2020-08-10,17253,1434,21,18708,13310.857142857143
2020-08-11,15154,1287,27,16468,13130.857142857143
2020-08-12,13415,1366,28,14809,13124
2020-08-13,13073,1135,17,14225,13178.142857142857
2020-08-14,13484,1121,15,14620,13141.857142857143
2020-08-15,5903,629,10,6542,13010.285714285714
2020-08-16,4822,530,14,5366,12962.57142857143
2020-08-17,13486,1477,21,14984,12430.57142857143
2020-08-18,13962,1197,21,15180,12246.57142857143
2020-08-19,12424,1240,22,13686,12086.142857142857
2020-08-20,11653,1217,22,12892,11895.714285714286
2020-08-21,11990,1087,12,13089,11677
2020-08-22,5481,555,8,6044,11605.857142857143
2020-08-23,3577,508,18,4103,11425.42857142857
2020-08-24,14013,1522,24,15559,11507.57142857143
2020-08-25,14112,1337,27,15476,11549.857142857143
2020-08-26,12459,1455,23,13937,11585.714285714286
2020-08-27,12162,1289,13,13464,11667.42857142857
2020-08-28,11903,1282,26,13211,11684.857142857143
2020-08-29,5613,689,13,6315,11723.57142857143
2020-08-30,4031,561,10,4602,11794.857142857143
2020-08-31,13699,1629,36,15364,11767
2020-09-01,13575,1436,27,15038,11704.42857142857
2020-09-02,13986,1485,44,15515,11929.857142857143
2020-09-03,14217,1319,63,15599,12234.857142857143
2020-09-04,13583,1235,12,14830,12466.142857142857
2020-09-05,6575,733,8,7316,12609.142857142857
2020-09-06,4925,588,34,5547,12744.142857142857
2020-09-07,5561,649,5,6215,11437.142857142857
2020-09-08,18287,1865,33,20185,12172.42857142857
2020-09-09,12282,1445,26,13753,11920.714285714286
2020-09-10,8505,1014,12,9531,11053.857142857143
