report_date,pcr_neg,pcr_pos,pcr_int,pcr_total,pcr_avg
2020-03-16,409,30,0,439,NA
2020-03-17,635,50,0,685,NA
2020-03-18,737,56,2,795,NA
2020-03-19,1056,71,1,1128,NA
2020-03-20,1076,104,2,1182,NA
2020-03-21,741,82,2,825,NA
2020-03-22,626,79,0,705,822.7142857142857
2020-03-23,1628,176,4,1808,1018.2857142857143
2020-03-24,1850,214,0,2064,1215.2857142857142
2020-03-25,2205,224,6,2435,1449.5714285714287
2020-03-26,2166,258,1,2425,1634.857142857143
2020-03-27,1841,296,0,2137,1771.2857142857142
2020-03-28,1090,193,2,1285,1837
2020-03-29,747,139,0,886,1862.857142857143
2020-03-30,2407,361,0,2768,2000
2020-03-31,2167,301,1,2469,2057.8571428571427
2020-04-01,2020,274,2,2296,2038
2020-04-02,1886,292,3,2181,2003.142857142857
2020-04-03,1731,250,2,1983,1981.142857142857
2020-04-04,950,145,2,1097,1954.2857142857142
2020-04-05,784,113,3,900,1956.2857142857142
2020-04-06,2417,319,7,2743,1952.7142857142858
2020-04-07,2081,242,2,2325,1932.142857142857
2020-04-08,2060,252,1,2313,1934.5714285714287
2020-04-09,1766,214,4,1984,1906.4285714285713
2020-04-10,1986,241,5,2232,1942
2020-04-11,851,105,1,957,1922
2020-04-12,694,98,3,795,1907
2020-04-13,1977,282,4,2263,1838.4285714285713
2020-04-14,1959,235,6,2200,1820.5714285714287
2020-04-15,1831,241,4,2076,1786.7142857142858
2020-04-16,1840,234,4,2078,1800.142857142857
2020-04-17,2171,202,4,2377,1820.857142857143
2020-04-18,1080,173,0,1253,1863.142857142857
2020-04-19,830,150,2,982,1889.857142857143
2020-04-20,2443,315,10,2768,1962
2020-04-21,2297,273,9,2579,2016.142857142857
2020-04-22,2704,279,6,2989,2146.5714285714284
2020-04-23,2639,282,9,2930,2268.285714285714
2020-04-24,2470,263,17,2750,2321.5714285714284
2020-04-25,1172,139,1,1312,2330
2020-04-26,1042,90,1,1133,2351.5714285714284
2020-04-27,3780,349,7,4136,2547
2020-04-28,4564,429,14,5007,2893.8571428571427
2020-04-29,4555,379,9,4943,3173
2020-04-30,3839,334,11,4184,3352.1428571428573
2020-05-01,4216,338,13,4567,3611.714285714286
2020-05-02,1577,92,2,1671,3663
2020-05-03,1089,89,2,1180,3669.714285714286
2020-05-04,3856,304,14,4174,3675.1428571428573
2020-05-05,4618,326,17,4961,3668.5714285714284
2020-05-06,4075,260,8,4343,3582.8571428571427
2020-05-07,3768,181,10,3959,3550.714285714286
2020-05-08,4390,178,6,4574,3551.714285714286
2020-05-09,2099,133,4,2236,3632.4285714285716
2020-05-10,1253,76,0,1329,3653.714285714286
2020-05-11,5055,261,11,5327,3818.4285714285716
2020-05-12,5257,233,7,5497,3895
2020-05-13,5340,339,9,5688,4087.1428571428573
2020-05-14,4860,266,3,5129,4254.285714285715
2020-05-15,5682,255,13,5950,4450.857142857143
2020-05-16,3882,99,2,3983,4700.428571428572
2020-05-17,2765,125,3,2893,4923.857142857143
2020-05-18,6444,283,6,6733,5124.714285714285
2020-05-19,5782,299,6,6087,5209
2020-05-20,5745,307,3,6055,5261.428571428572
2020-05-21,5581,320,10,5911,5373.142857142857
2020-05-22,6892,251,9,7152,5544.857142857143
2020-05-23,2987,109,2,3098,5418.428571428572
2020-05-24,2457,82,3,2542,5368.285714285715
2020-05-25,2348,94,2,2444,4755.571428571428
2020-05-26,12653,362,13,13028,5747.142857142857
2020-05-27,11511,356,10,11877,6578.857142857143
2020-05-28,10206,271,7,10484,7232.142857142857
2020-05-29,9476,271,7,9754,7603.857142857143
2020-05-30,4329,327,4,4660,7827
2020-05-31,2767,215,3,2985,7890.285714285715
2020-06-01,10084,354,81,10519,9043.857142857143
2020-06-02,8397,283,13,8693,8424.57142857143
2020-06-03,8770,282,10,9062,8022.428571428572
2020-06-04,7637,309,18,7964,7662.428571428572
2020-06-05,8692,322,9,9023,7558
2020-06-06,3315,125,3,3443,7384.142857142857
2020-06-07,2322,81,0,2403,7301
2020-06-08,9490,368,8,9866,7207.714285714285
2020-06-09,10174,386,2,10562,7474.714285714285
2020-06-10,9894,378,10,10282,7649
2020-06-11,7935,446,7,8388,7709.571428571428
2020-06-12,8451,389,10,8850,7684.857142857143
2020-06-13,3820,171,6,3997,7764
2020-06-14,2601,124,1,2726,7810.142857142857
2020-06-15,13848,520,43,14411,8459.42857142857
2020-06-16,11652,577,112,12341,8713.57142857143
2020-06-17,9768,512,19,10299,8716
2020-06-18,9494,664,41,10199,8974.714285714286
2020-06-19,10492,492,18,11002,9282.142857142857
2020-06-20,4480,258,11,4749,9389.57142857143
2020-06-21,2877,233,0,3110,9444.42857142857
2020-06-22,15401,719,92,16212,9701.714285714286
2020-06-23,11690,667,26,12383,9707.714285714286
2020-06-24,11009,745,29,11783,9919.714285714286
2020-06-25,9443,653,16,10112,9907.285714285714
2020-06-26,11770,665,10,12445,10113.42857142857
2020-06-27,5562,428,3,5993,10291.142857142857
2020-06-28,4619,289,2,4910,10548.285714285714
2020-06-29,17535,996,33,18564,10884.285714285714
2020-06-30,14240,1008,15,15263,11295.714285714286
2020-07-01,13499,1066,25,14590,11696.714285714286
2020-07-02,12583,1099,14,13696,12208.714285714286
2020-07-03,8005,717,15,8737,11679
2020-07-04,3627,358,5,3990,11392.857142857143
2020-07-05,4039,379,0,4418,11322.57142857143
2020-07-06,16028,1292,13,17333,11146.714285714286
2020-07-07,15812,1339,18,17169,11419
2020-07-08,15363,1463,21,16847,11741.42857142857
2020-07-09,15256,1342,40,16638,12161.714285714286
2020-07-10,14909,1288,36,16233,13232.57142857143
2020-07-11,8710,715,28,9453,14013
2020-07-12,5791,496,7,6294,14281
2020-07-13,20705,1533,53,22291,14989.285714285714
2020-07-14,18066,1455,34,19555,15330.142857142857
2020-07-15,16333,1276,22,17631,15442.142857142857
2020-07-16,13628,1220,15,14863,15188.57142857143
2020-07-17,14645,1181,15,15841,15132.57142857143
2020-07-18,7541,760,14,8315,14970
2020-07-19,4998,552,12,5562,14865.42857142857
2020-07-20,20203,1698,32,21933,14814.285714285714
2020-07-21,16709,1455,34,18198,14620.42857142857
2020-07-22,13644,1411,22,15077,14255.57142857143
2020-07-23,14255,1397,35,15687,14373.285714285714
2020-07-24,14524,1317,28,15869,14377.285714285714
2020-07-25,7642,651,10,8303,14375.57142857143
2020-07-26,5402,489,15,5906,14424.714285714286
2020-07-27,18597,1545,40,20182,14174.57142857143
2020-07-28,17472,1326,31,18829,14264.714285714286
2020-07-29,13648,1411,29,15088,14266.285714285714
2020-07-30,12500,1234,20,13754,13990.142857142857
2020-07-31,12966,1120,10,14096,13736.857142857143
2020-08-01,7232,610,20,7862,13673.857142857143
2020-08-02,5370,614,22,6006,13688.142857142857
2020-08-03,19903,1641,43,21587,13888.857142857143
2020-08-04,15986,1423,30,17439,13690.285714285714
2020-08-05,13065,1361,18,14444,13598.285714285714
2020-08-06,12332,1145,11,13488,13560.285714285714
2020-08-07,13258,1092,20,14370,13599.42857142857
2020-08-08,6693,693,10,7396,13532.857142857143
2020-08-09,5163,469,8,5640,13480.57142857143
2020-08-10,17017,1446,20,18483,13037.142857142857
2020-08-11,14222,1244,27,15493,12759.142857142857
2020-08-12,12126,1397,35,13558,12632.57142857143
2020-08-13,12831,1119,16,13966,12700.857142857143
2020-08-14,13447,1115,16,14578,12730.57142857143
2020-08-15,5940,649,10,6599,12616.714285714286
2020-08-16,4867,539,13,5419,12585.142857142857
2020-08-17,12723,1502,22,14247,11980
2020-08-18,13168,1211,25,14404,11824.42857142857
2020-08-19,11296,1263,22,12581,11684.857142857143
2020-08-20,10114,1244,25,11383,11315.857142857143
2020-08-21,10238,1111,12,11361,10856.285714285714
2020-08-22,4647,566,8,5221,10659.42857142857
2020-08-23,3651,512,18,4181,10482.57142857143
2020-08-24,12900,1480,23,14403,10504.857142857143
2020-08-25,11903,1212,19,13134,10323.42857142857
2020-08-26,7280,886,17,8183,9695.142857142857
