report_date,pcr_neg,pcr_pos,pcr_int,pcr_total,pcr_avg
2020-03-16,409,30,0,439,NA
2020-03-17,635,50,0,685,NA
2020-03-18,737,57,2,796,NA
2020-03-19,1057,71,1,1129,NA
2020-03-20,1076,104,2,1182,NA
2020-03-21,741,82,2,825,NA
2020-03-22,626,80,0,706,823.1428571428571
2020-03-23,1629,176,4,1809,1018.8571428571429
2020-03-24,1850,214,0,2064,1215.857142857143
2020-03-25,2205,224,6,2435,1450
2020-03-26,2166,258,1,2425,1635.142857142857
2020-03-27,1841,296,0,2137,1771.5714285714287
2020-03-28,1090,193,2,1285,1837.2857142857142
2020-03-29,747,139,0,886,1863
2020-03-30,2407,361,0,2768,2000
2020-03-31,2167,301,1,2469,2057.8571428571427
2020-04-01,2020,274,2,2296,2038
2020-04-02,1886,292,3,2181,2003.142857142857
2020-04-03,1731,251,2,1984,1981.2857142857142
2020-04-04,950,145,2,1097,1954.4285714285713
2020-04-05,784,113,3,900,1956.4285714285713
2020-04-06,2417,319,7,2743,1952.857142857143
2020-04-07,2081,242,2,2325,1932.2857142857142
2020-04-08,2060,252,1,2313,1934.7142857142858
2020-04-09,1766,215,4,1985,1906.7142857142858
2020-04-10,1986,241,5,2232,1942.142857142857
2020-04-11,851,105,1,957,1922.142857142857
2020-04-12,694,101,3,798,1907.5714285714287
2020-04-13,1977,287,4,2268,1839.7142857142858
2020-04-14,1959,235,6,2200,1821.857142857143
2020-04-15,1831,241,4,2076,1788
2020-04-16,1840,234,4,2078,1801.2857142857142
2020-04-17,2171,202,4,2377,1822
2020-04-18,1080,174,0,1254,1864.4285714285713
2020-04-19,830,150,2,982,1890.7142857142858
2020-04-20,2443,315,10,2768,1962.142857142857
2020-04-21,2297,274,9,2580,2016.4285714285713
2020-04-22,2704,279,6,2989,2146.8571428571427
2020-04-23,2640,281,9,2930,2268.5714285714284
2020-04-24,2470,263,17,2750,2321.8571428571427
2020-04-25,1172,139,1,1312,2330.1428571428573
2020-04-26,1042,90,1,1133,2351.714285714286
2020-04-27,3787,349,7,4143,2548.1428571428573
2020-04-28,4566,429,14,5009,2895.1428571428573
2020-04-29,4569,379,9,4957,3176.285714285714
2020-04-30,3845,335,11,4191,3356.4285714285716
2020-05-01,4222,338,13,4573,3616.8571428571427
2020-05-02,1577,92,2,1671,3668.1428571428573
2020-05-03,1089,89,2,1180,3674.8571428571427
2020-05-04,3859,304,14,4177,3679.714285714286
2020-05-05,4619,325,17,4961,3672.8571428571427
2020-05-06,4078,260,8,4346,3585.5714285714284
2020-05-07,3769,180,10,3959,3552.4285714285716
2020-05-08,4391,178,6,4575,3552.714285714286
2020-05-09,2099,133,4,2236,3633.4285714285716
2020-05-10,1253,76,0,1329,3654.714285714286
2020-05-11,5060,261,11,5332,3819.714285714286
2020-05-12,5270,235,7,5512,3898.4285714285716
2020-05-13,5346,339,9,5694,4091
2020-05-14,4866,266,3,5135,4259
2020-05-15,5685,254,13,5952,4455.714285714285
2020-05-16,3882,99,2,3983,4705.285714285715
2020-05-17,2765,125,3,2893,4928.714285714285
2020-05-18,6445,283,6,6734,5129
2020-05-19,5784,298,6,6088,5211.285714285715
2020-05-20,5748,307,3,6058,5263.285714285715
2020-05-21,5586,320,10,5916,5374.857142857143
2020-05-22,6899,251,9,7159,5547.285714285715
2020-05-23,2987,109,2,3098,5420.857142857143
2020-05-24,2458,82,3,2543,5370.857142857143
2020-05-25,2348,94,2,2444,4758
2020-05-26,12656,362,13,13031,5749.857142857143
2020-05-27,11515,357,10,11882,6581.857142857143
2020-05-28,10209,271,7,10487,7234.857142857143
2020-05-29,9481,271,7,9759,7606.285714285715
2020-05-30,4329,327,4,4660,7829.428571428572
2020-05-31,2767,215,3,2985,7892.571428571428
2020-06-01,10085,354,81,10520,9046.285714285714
2020-06-02,8405,283,13,8701,8427.714285714286
2020-06-03,8777,281,10,9068,8025.714285714285
2020-06-04,7640,309,18,7967,7665.714285714285
2020-06-05,8698,322,9,9029,7561.428571428572
2020-06-06,3315,125,3,3443,7387.571428571428
2020-06-07,2322,81,0,2403,7304.428571428572
2020-06-08,9499,368,8,9875,7212.285714285715
2020-06-09,10174,386,2,10562,7478.142857142857
2020-06-10,9897,378,10,10285,7652
2020-06-11,7936,447,7,8390,7712.428571428572
2020-06-12,8452,389,10,8851,7687
2020-06-13,3820,171,6,3997,7766.142857142857
2020-06-14,2601,124,1,2726,7812.285714285715
2020-06-15,13848,520,43,14411,8460.285714285714
2020-06-16,11654,577,112,12343,8714.714285714286
2020-06-17,9770,513,19,10302,8717.142857142857
2020-06-18,9495,666,41,10202,8976
2020-06-19,10493,492,18,11003,9283.42857142857
2020-06-20,4480,258,11,4749,9390.857142857143
2020-06-21,2877,234,0,3111,9445.857142857143
2020-06-22,15401,720,92,16213,9703.285714285714
2020-06-23,11693,668,27,12388,9709.714285714286
2020-06-24,11014,746,29,11789,9922.142857142857
2020-06-25,9445,654,17,10116,9909.857142857143
2020-06-26,11772,668,10,12450,10116.57142857143
2020-06-27,5562,428,3,5993,10294.285714285714
2020-06-28,4619,289,2,4910,10551.285714285714
2020-06-29,17536,997,33,18566,10887.42857142857
2020-06-30,14247,1009,16,15272,11299.42857142857
2020-07-01,13505,1071,25,14601,11701.142857142857
2020-07-02,12586,1103,14,13703,12213.57142857143
2020-07-03,8007,728,14,8749,11684.857142857143
2020-07-04,3626,358,6,3990,11398.714285714286
2020-07-05,4039,380,0,4419,11328.57142857143
2020-07-06,16035,1298,13,17346,11154.285714285714
2020-07-07,15829,1368,19,17216,11432
2020-07-08,15487,1481,21,16989,11773.142857142857
2020-07-09,15260,1344,40,16644,12193.285714285714
2020-07-10,14926,1291,34,16251,13265
2020-07-11,8710,715,28,9453,14045.42857142857
2020-07-12,5791,497,7,6295,14313.42857142857
2020-07-13,20724,1543,54,22321,15024.142857142857
2020-07-14,18105,1512,34,19651,15372
2020-07-15,16336,1316,22,17674,15469.857142857143
2020-07-16,13631,1224,15,14870,15216.42857142857
2020-07-17,14749,1190,15,15954,15174
2020-07-18,7541,766,14,8321,15012.285714285714
2020-07-19,5014,554,12,5580,14910.142857142857
2020-07-20,20212,1703,32,21947,14856.714285714286
2020-07-21,16728,1455,34,18217,14651.857142857143
2020-07-22,13653,1427,22,15102,14284.42857142857
2020-07-23,14306,1408,35,15749,14410
2020-07-24,14551,1328,29,15908,14403.42857142857
2020-07-25,7649,653,10,8312,14402.142857142857
2020-07-26,5403,490,15,5908,14449
2020-07-27,18655,1550,40,20245,14205.857142857143
2020-07-28,17653,1336,30,19019,14320.42857142857
2020-07-29,13786,1427,29,15242,14340.42857142857
2020-07-30,12587,1249,20,13856,14070
2020-07-31,13003,1125,10,14138,13817.142857142857
2020-08-01,7245,612,20,7877,13755
2020-08-02,5373,615,22,6010,13769.57142857143
2020-08-03,20021,1663,43,21727,13981.285714285714
2020-08-04,16098,1434,27,17559,13772.714285714286
2020-08-05,13275,1371,20,14666,13690.42857142857
2020-08-06,12406,1161,10,13577,13650.57142857143
2020-08-07,13442,1096,18,14556,13710.285714285714
2020-08-08,6660,703,10,7373,13638.285714285714
2020-08-09,5157,470,9,5636,13584.857142857143
2020-08-10,17120,1422,19,18561,13132.57142857143
2020-08-11,14385,1276,26,15687,12865.142857142857
2020-08-12,12176,1415,35,13626,12716.57142857143
2020-08-13,12998,1115,18,14131,12795.714285714286
2020-08-14,13464,1123,13,14600,12802
2020-08-15,5937,633,10,6580,12688.714285714286
2020-08-16,4859,534,14,5407,12656
2020-08-17,13276,1492,23,14791,12117.42857142857
2020-08-18,13776,1196,23,14995,12018.57142857143
2020-08-19,11961,1241,20,13222,11960.857142857143
2020-08-20,10185,1216,20,11421,11573.714285714286
2020-08-21,10287,1092,15,11394,11115.714285714286
2020-08-22,4923,561,6,5490,10960
2020-08-23,3645,513,20,4178,10784.42857142857
2020-08-24,13552,1542,25,15119,10831.285714285714
2020-08-25,13497,1335,24,14856,10811.42857142857
2020-08-26,12195,1458,22,13675,10876.142857142857
2020-08-27,11182,1294,11,12487,11028.42857142857
2020-08-28,11157,1274,18,12449,11179.142857142857
2020-08-29,4535,701,11,5247,11144.42857142857
2020-08-30,3292,564,9,3865,11099.714285714286
2020-08-31,10352,1594,35,11981,10651.42857142857
2020-09-01,8037,946,10,8993,9813.857142857143
