report_date,pcr_neg,pcr_pos,pcr_int,pcr_total,pcr_avg
2020-03-16,409,30,0,439,NA
2020-03-17,635,50,0,685,NA
2020-03-18,737,56,2,795,NA
2020-03-19,1056,71,1,1128,NA
2020-03-20,1076,104,2,1182,NA
2020-03-21,741,82,2,825,NA
2020-03-22,626,79,0,705,822.7142857142857
2020-03-23,1628,176,4,1808,1018.2857142857143
2020-03-24,1850,214,0,2064,1215.2857142857142
2020-03-25,2205,224,6,2435,1449.5714285714287
2020-03-26,2166,258,1,2425,1634.857142857143
2020-03-27,1841,296,0,2137,1771.2857142857142
2020-03-28,1090,193,2,1285,1837
2020-03-29,747,139,0,886,1862.857142857143
2020-03-30,2407,361,0,2768,2000
2020-03-31,2167,301,1,2469,2057.8571428571427
2020-04-01,2021,274,2,2297,2038.142857142857
2020-04-02,1886,292,3,2181,2003.2857142857142
2020-04-03,1731,250,2,1983,1981.2857142857142
2020-04-04,950,145,2,1097,1954.4285714285713
2020-04-05,784,113,3,900,1956.4285714285713
2020-04-06,2417,319,7,2743,1952.857142857143
2020-04-07,2081,242,2,2325,1932.2857142857142
2020-04-08,2060,252,1,2313,1934.5714285714287
2020-04-09,1766,214,4,1984,1906.4285714285713
2020-04-10,1986,241,5,2232,1942
2020-04-11,851,105,1,957,1922
2020-04-12,694,98,3,795,1907
2020-04-13,1977,282,4,2263,1838.4285714285713
2020-04-14,1959,235,6,2200,1820.5714285714287
2020-04-15,1831,241,4,2076,1786.7142857142858
2020-04-16,1840,234,4,2078,1800.142857142857
2020-04-17,2171,202,4,2377,1820.857142857143
2020-04-18,1080,173,0,1253,1863.142857142857
2020-04-19,830,150,2,982,1889.857142857143
2020-04-20,2443,315,10,2768,1962
2020-04-21,2297,274,9,2580,2016.2857142857142
2020-04-22,2704,279,6,2989,2146.714285714286
2020-04-23,2639,281,9,2929,2268.285714285714
2020-04-24,2470,263,17,2750,2321.5714285714284
2020-04-25,1172,139,1,1312,2330
2020-04-26,1042,90,1,1133,2351.5714285714284
2020-04-27,3780,349,7,4136,2547
2020-04-28,4564,429,14,5007,2893.714285714286
2020-04-29,4555,379,9,4943,3172.8571428571427
2020-04-30,3839,333,11,4183,3352
2020-05-01,4216,335,13,4564,3611.1428571428573
2020-05-02,1577,93,2,1672,3662.5714285714284
2020-05-03,1089,89,2,1180,3669.285714285714
2020-05-04,3856,302,14,4172,3674.4285714285716
2020-05-05,4618,326,17,4961,3667.8571428571427
2020-05-06,4075,258,8,4341,3581.8571428571427
2020-05-07,3768,181,10,3959,3549.8571428571427
2020-05-08,4390,177,6,4573,3551.1428571428573
2020-05-09,2099,133,4,2236,3631.714285714286
2020-05-10,1253,76,0,1329,3653
2020-05-11,5055,260,11,5326,3817.8571428571427
2020-05-12,5257,232,7,5496,3894.285714285714
2020-05-13,5340,339,9,5688,4086.714285714286
2020-05-14,4860,266,3,5129,4253.857142857143
2020-05-15,5682,253,13,5948,4450.285714285715
2020-05-16,3882,99,2,3983,4699.857142857143
2020-05-17,2765,124,3,2892,4923.142857142857
2020-05-18,6443,283,6,6732,5124
2020-05-19,5782,299,6,6087,5208.428571428572
2020-05-20,5745,306,3,6054,5260.714285714285
2020-05-21,5581,321,10,5912,5372.571428571428
2020-05-22,6892,251,9,7152,5544.571428571428
2020-05-23,2987,109,2,3098,5418.142857142857
2020-05-24,2457,82,3,2542,5368.142857142857
2020-05-25,2348,93,2,2443,4755.428571428572
2020-05-26,12653,362,13,13028,5747
2020-05-27,11510,356,10,11876,6578.714285714285
2020-05-28,10206,270,7,10483,7231.714285714285
2020-05-29,9474,270,7,9751,7603
2020-05-30,4329,323,4,4656,7825.571428571428
2020-05-31,2767,212,3,2982,7888.428571428572
2020-06-01,10082,349,81,10512,9041.142857142857
2020-06-02,8397,282,13,8692,8421.714285714286
2020-06-03,8770,278,10,9058,8019.142857142857
2020-06-04,7637,308,18,7963,7659.142857142857
2020-06-05,8691,322,9,9022,7555
2020-06-06,3315,124,3,3442,7381.571428571428
2020-06-07,2322,81,0,2403,7298.857142857143
2020-06-08,9489,368,8,9865,7206.428571428572
2020-06-09,10172,387,2,10561,7473.428571428572
2020-06-10,9894,378,10,10282,7648.285714285715
2020-06-11,7935,347,7,8289,7694.857142857143
2020-06-12,8451,389,10,8850,7670.285714285715
2020-06-13,3820,171,6,3997,7749.571428571428
2020-06-14,2601,124,1,2726,7795.714285714285
2020-06-15,13847,520,43,14410,8445
2020-06-16,11651,577,112,12340,8699.142857142857
2020-06-17,9768,512,19,10299,8701.57142857143
2020-06-18,9492,664,41,10197,8974.142857142857
2020-06-19,10491,492,18,11001,9281.42857142857
2020-06-20,4480,258,11,4749,9388.857142857143
2020-06-21,2877,233,0,3110,9443.714285714286
2020-06-22,15401,719,92,16212,9701.142857142857
2020-06-23,11688,668,26,12382,9707.142857142857
2020-06-24,11005,745,29,11779,9918.57142857143
2020-06-25,9440,653,16,10109,9906
2020-06-26,11767,667,10,12444,10112.142857142857
2020-06-27,5562,412,3,5977,10287.57142857143
2020-06-28,4619,278,2,4899,10543.142857142857
2020-06-29,17531,984,33,18548,10876.857142857143
2020-06-30,14239,989,16,15244,11285.714285714286
2020-07-01,13500,1062,25,14587,11686.857142857143
2020-07-02,12581,1077,14,13672,12195.857142857143
2020-07-03,8005,715,14,8734,11665.857142857143
2020-07-04,3627,359,6,3992,11382.285714285714
2020-07-05,4039,378,0,4417,11313.42857142857
2020-07-06,16025,1298,12,17335,11140.142857142857
2020-07-07,15811,1344,18,17173,11415.714285714286
2020-07-08,15359,1464,21,16844,11738.142857142857
2020-07-09,15248,1324,39,16611,12158
2020-07-10,14905,1272,36,16213,13226.42857142857
2020-07-11,8709,716,28,9453,14006.57142857143
2020-07-12,5791,494,7,6292,14274.42857142857
2020-07-13,20705,1535,52,22292,14982.57142857143
2020-07-14,18063,1455,35,19553,15322.57142857143
2020-07-15,16325,1274,22,17621,15433.57142857143
2020-07-16,13615,1222,14,14851,15182.142857142857
2020-07-17,14626,1177,14,15817,15125.57142857143
2020-07-18,7541,757,15,8313,14962.714285714286
2020-07-19,5005,554,12,5571,14859.714285714286
2020-07-20,20185,1698,32,21915,14805.857142857143
2020-07-21,16704,1450,34,18188,14610.857142857143
2020-07-22,13624,1410,22,15056,14244.42857142857
2020-07-23,14236,1399,35,15670,14361.42857142857
2020-07-24,14509,1321,25,15855,14366.857142857143
2020-07-25,7642,651,10,8303,14365.42857142857
2020-07-26,5397,493,15,5905,14413.142857142857
2020-07-27,18554,1546,40,20140,14159.57142857143
2020-07-28,17442,1324,31,18797,14246.57142857143
2020-07-29,13597,1413,27,15037,14243.857142857143
2020-07-30,12439,1234,18,13691,13961.142857142857
2020-07-31,12946,1120,10,14076,13707
2020-08-01,7223,610,20,7853,13642.714285714286
2020-08-02,5363,612,22,5997,13655.857142857143
2020-08-03,19860,1643,40,21543,13856.285714285714
2020-08-04,15941,1415,26,17382,13654.142857142857
2020-08-05,13028,1358,20,14406,13564
2020-08-06,12310,1129,11,13450,13529.57142857143
2020-08-07,13278,1099,21,14398,13575.57142857143
2020-08-08,6712,699,9,7420,13513.714285714286
2020-08-09,5141,484,6,5631,13461.42857142857
2020-08-10,17061,1456,22,18539,13032.285714285714
2020-08-11,14201,1249,28,15478,12760.285714285714
2020-08-12,12056,1421,36,13513,12632.714285714286
2020-08-13,12651,1150,16,13817,12685.142857142857
2020-08-14,13460,1134,16,14610,12715.42857142857
2020-08-15,5945,641,13,6599,12598.142857142857
2020-08-16,4893,535,15,5443,12571.285714285714
2020-08-17,12585,1487,22,14094,11936.285714285714
2020-08-18,12026,1191,27,13244,11617.142857142857
2020-08-19,8834,1183,16,10033,11120
2020-08-20,7205,987,17,8209,10318.857142857143
2020-08-21,6299,678,9,6986,9229.714285714286
